wubi86.109.dict.yaml
龸	ipb	ipv
䶿	wpqn	wyvq
𪛗	wgkf	wgmn
𪛘	lhng	mqnv
𪛙	ggll	nnll
𪛚	hhgg	hnv
𪛛	nyi	nnv
𪛜	aaaa	ghnv
𪛝	myi	tnyi
鿮	ygkh	yahh

wubi86.cjk_strokes.dict.yaml
㇘(SWZ)	nnll	hgd

wubi86.extc.dict.yaml
𪜊	ynb	ynv
𪜚	inst	istn
𪝶	wynn	wynx
𪟟	qjql	qlql
𪠶	kwfg	kfwy
𪠿	kthh	kth
𪡲	vkgd	kvgd
𪢓	yniy	ynig
𪢛	kmeh	kmqh
𪤧	fvgw	fwfw
𪥑	dfie	dfin
𪥘	ukhd	uskd
𪦧	vfbh	vbfh
𪨽	muxf	mfux
𪩽	mhxd	mhad
𪫈	gkhe	fkwe
𪫕	txit	txty
𪬍	nhkn	nhky

wubi86.extd.dict.yaml
𫝄	twu	twi
𫝂	guth	geth
𫝯	vgnb	wfgb
𫟋	vgnw	wfgw