龦	oiph
龧	jjfj
龨	awyd
龩	aafr
龪	fhwi
龫	lwfh
龬	qmun
龭	claw
龮	cnlw
龯	qdnt
龰	hhgy
龱	lqi
龲	qylh
龳	fwff
龴	cny
龵	rtgt
龶	gggg
龷	aghg
龸	ipb	ipv
龹	udi
龺	fjj
龻	xyxy
龼	fhph
龽	oqoy
龾	hcqo
龿	awff
鿀	aatg
鿁	yawy
鿂	lwvo
鿃	hdty	hdww
鿄	ivys
鿅	pyfc
鿆	pydc
鿇	wqvh
鿈	tnyy
鿉	tgg
鿊	aihf
鿋	pufk
鿌	iyji
鿍	ftah
鿎	ddpy
鿏	qgty
鿐	qoig
鿑	ugyy
鿒	admu
鿓	admu
鿔	qskk
鿕	qgmy
鿖	wgkg
鿗	wwvg
鿘	wvtk
鿙	wvtq
鿚	wvtk
鿛	ufwq
鿜	rugq
鿝	slyq
鿞	gqjq
鿟	tjqi
鿠	tjgq
鿡	lxwq
鿢	bbwk
鿣	bbdq
鿤	bbsk
鿥	yvcq
鿦	amdt
鿧	btgq
鿨	flgq
鿩	qojq
鿪	uepo
鿫	rntd
鿬	dlg
鿭	qqiy
鿮	ygkh	ygmh
鿯	trqo
鿰	ifjh
鿱	gcn
鿲	gkul
鿳	qotx
鿴	qgtu
鿵	qgfn
鿶	qgye
鿷	qguj
鿸	qgtx
鿹	qgpm
鿺	gtqg
鿻	vnuh
鿼	vnuk
鿽	kpwf
鿾	fyvb
鿿	gehi
