𪜀	fnv
𪜁	gbj
𪜂	gvyu
𪜃	gkvn
𪜄	gisk
𪜅	sufj
𪜆	gxxh
𪜇	dnww
𪜈	hgan
𪜉	khgh
𪜊	ynb	ynv
𪜋	ygat
𪜌	ejd
𪜍	tfiq
𪜎	tdjm
𪜏	tdut
𪜐	nwxv
𪜑	gsnb
𪜒	nfkd
𪜓	wrhn
𪜔	vmad
𪜕	ftjn
𪜖	nfmd	nflf
𪜗	vakg
𪜘	dnhc
𪜙	vdja
𪜚	inst	istn
𪜛	ebnh
𪜜	uxbh
𪜝	cbaw
𪜞	fcdt
𪜟	ybvc
𪜠	ymyu
𪜡	ntyn
𪜢	yhjf
𪜣	ucwa
𪜤	ywwy
𪜥	ylkh
𪜦	ypsl
𪜧	wqy
𪜨	wgvg
𪜩	wqcy
𪜪	wqxn
𪜫	wnfg
𪜬	wfiu
𪜭	wlng
𪜮	whg
𪜯	wkln
𪜰	wty
𪜱	wtu
𪜲	wryy
𪜳	wnan
𪜴	wxcy
𪜵	wxjg
𪜶	wldy
𪜷	wesy
𪜸	wpbg
𪜹	wng
𪜺	wxfy
𪜻	wfoy
𪜼	wahh
𪜽	wjff
𪜾	wegl
𪜿	wjvg
𪝀	wqeh
𪝁	wekx
𪝂	wyjg
𪝃	wtcy
𪝄	wdun
𪝅	wsty
𪝆	wayn
𪝇	whmt
𪝈	wepc
𪝉	wtsy
𪝊	wyqy
𪝋	wshg
𪝌	walg
𪝍	wdeg
𪝎	wswc
𪝏	waqk
𪝐	wdjb
𪝑	wjlg
𪝒	wwdc
𪝓	wwae
𪝔	wqbn
𪝕	wwvl
𪝖	wamy
𪝗	swwq
𪝘	wdep
𪝙	wfcl
𪝚	wjiq
𪝛	wrvc
𪝜	wwnh
𪝝	weud
𪝞	wuwl
𪝟	wxuu
𪝠	wlat
𪝡	wajd
𪝢	wlye
𪝣	wpdk
𪝤	wpgw
𪝥	wdmj
𪝦	wffk	wfkk
𪝧	wjoo
𪝨	wqao
𪝩	wudh
𪝪	wnhh
𪝫	wgoc
𪝬	wdyf
𪝭	whad
𪝮	wytq
𪝯	wujf
𪝰	wgcy
𪝱	wmwh
𪝲	towg
𪝳	wiaw
𪝴	wsdp
𪝵	wqyj
𪝶	wynn	wynx
𪝷	wfvq
𪝸	wafy
𪝹	wynt
𪝺	wfnc
𪝻	wgcs
𪝼	wmmv
𪝽	whmm
𪝾	wdej
𪝿	jbqb
𪞀	iqqh
𪞁	qkqc
𪞂	qkqj
𪞃	iqjg
𪞄	tfqd
𪞅	ycqk
𪞆	iqho
𪞇	wgwv
𪞈	wxfj
𪞉	fkaw
𪞊	wumk
𪞋	vcew
𪞌	ulyk
𪞍	uvok
𪞎	mdd
𪞏	pqbb
𪞐	pwbf
𪞑	pwkh
𪞒	pfqf
𪞓	pwye
𪞔	pwbc
𪞕	pdhl
𪞖	umyy
𪞗	umwy
𪞘	uwyn
𪞙	uyy
𪞚	unyy
𪞛	ulg
𪞜	urg
𪞝	ucfh
𪞞	udnt
𪞟	dwuu
𪞠	uwyb
𪞡	uwfi
𪞢	udff
𪞣	uham
𪞤	uwyn
𪞥	upfi
𪞦	uleg
𪞧	uwyq
𪞨	uyps
𪞩	uawy
𪞪	uwqu
𪞫	ugkt
𪞬	uujh
𪞭	uffq
𪞮	ufwc
𪞯	uype
𪞰	uucy
𪞱	fpmb
𪞲	mhkd
𪞳	tfum
𪞴	myfk
𪞵	mfvd
𪞶	tygb
𪞷	bmah
𪞸	ybtf
𪞹	bmvn
𪞺	bmen
𪞻	ybkd
𪞼	ybuw
𪞽	ybme
𪞾	fwjh
𪞿	gbnj
𪟀	vyn
𪟁	dcjh
𪟂	hkvn
𪟃	ddjh
𪟄	ubtj
𪟅	unwj
𪟆	ycej
𪟇	rwjh
𪟈	ftjj
𪟉	dufj
𪟊	degv
𪟋	afjh
𪟌	fkuj
𪟍	uejh
𪟎	jtyj
𪟏	tguj	tfuj
𪟐	wvqh
𪟑	yqkv
𪟒	yttj
𪟓	vbjx
𪟔	lwwj
𪟕	tadj
𪟖	vhgj
𪟗	lksj
𪟘	rgln
𪟙	vcln
𪟚	qkln
𪟛	ivyl
𪟜	iitl
𪟝	gmln
𪟞	llft
𪟟	qqlv	qjql
𪟠	ujln
𪟡	llsk
𪟢	uwll
𪟣	kkml
𪟤	gall
𪟥	agal
𪟦	llwy
𪟧	llll
𪟨	nxv
𪟩	xgdu
𪟪	uxgi
𪟫	xxrg
𪟬	aed
𪟭	aanh
𪟮	aqnr
𪟯	ajfd
𪟰	awtk
𪟱	aosd
𪟲	aujm
𪟳	tfqh
𪟴	dftn
𪟵	fjvy
𪟶	ufik
𪟷	hjch
𪟸	ufuy
𪟹	fpxc
𪟺	fjwj
𪟻	wywf
𪟼	ywww
𪟽	hbj
𪟾	fihi
𪟿	hjhy
𪠀	hpgf
𪠁	wgkb
𪠂	cvcb
𪠃	dcd
𪠄	djnv
𪠅	dfkd
𪠆	duak
𪠇	dfoi
𪠈	dkkn
𪠉	dhqh
𪠊	djdi
𪠋	dfhd
𪠌	dxdm
𪠍	ddei
𪠎	dwcn
𪠏	ddhc
𪠐	dwfg
𪠑	dgef
𪠒	deut
𪠓	damw
𪠔	drxc	dvcc
𪠕	dnwy
𪠖	dogy
𪠗	djbk
𪠘	dqeh
𪠙	duen
𪠚	dttl
𪠛	dkkt
𪠜	ycmh	gcmh
𪠝	fcnx
𪠞	qqfc
𪠟	cdeq
𪠠	ctdw
𪠡	cdew
𪠢	fcyw
𪠣	qcu
𪠤	vcy
𪠥	cef
𪠦	dfcy
𪠧	scy
𪠨	vcu
𪠩	wfic
𪠪	nhfc
𪠫	udrc
𪠬	vdcy
𪠭	rcbg
𪠮	pwwc
𪠯	akkc
𪠰	cccj
𪠱	bcfy
𪠲	kcu
𪠳	klh
𪠴	kqqy
𪠵	kwxn
𪠶	kwfg	kfwy
𪠷	kqkf
𪠸	kqiy
𪠹	pykf
𪠺	krvy
𪠻	kycq
𪠼	kmww
𪠽	kivg
𪠾	ktey
𪠿	kthh	kth
𪡀	ktdj
𪡁	kycq
𪡂	kcah	kcfh
𪡃	knud
𪡄	kalh
𪡅	gkkd
𪡆	krwn
𪡇	kwqi
𪡈	kwrg
𪡉	kkqh
𪡊	keet
𪡋	kwgi
𪡌	iqwk
𪡍	ykqh
𪡎	klwc
𪡏	klpy
𪡐	dklk
𪡑	skiv
𪡒	kfuf
𪡓	kjxx
𪡔	klah
𪡕	kqrr
𪡖	kqld
𪡗	krqw
𪡘	qqkh
𪡙	kyvb
𪡚	kitg
𪡛	kusk
𪡜	dukq
𪡝	kawn
𪡞	kkhm
𪡟	kwct
𪡠	kriy
𪡡	kqyg
𪡢	vkkj
𪡣	kpgm
𪡤	irek
𪡥	kiaw
𪡦	kuhb
𪡧	kusg
𪡨	knoy
𪡩	kmdo
𪡪	dfek
𪡫	kfke
𪡬	djtk
𪡭	ksgn
𪡮	kmfy
𪡯	kmun
𪡰	kkvb
𪡱	kdin
𪡲	vkgd
𪡳	ukck
𪡴	kynn
𪡵	kike
𪡶	kpqy
𪡷	kbwt
𪡸	kruv
𪡹	fnmk
𪡺	kgom
𪡻	ahjd
𪡼	kkhd
𪡽	kjfh
𪡾	kttg
𪡿	kega
𪢀	ktlt
𪢁	kyja
𪢂	kudh
𪢃	kybt
𪢄	knug
𪢅	krnf
𪢆	kftp
𪢇	kssp
𪢈	rgkv
𪢉	ktmk
𪢊	ktli
𪢋	kwsm
𪢌	kugi
𪢍	kxfk
𪢎	kbkg
𪢏	dfeb
𪢐	kgkm
𪢑	ktwk
𪢒	kovt
𪢓	yniw
𪢔	kyno
𪢕	kgqm
𪢖	ktqn
𪢗	kpnj
𪢘	kugi
𪢙	kgjh
𪢚	krjc
𪢛	kmqh
𪢜	kqgy
𪢝	ktfn
𪢞	xtbk
𪢟	kymd
𪢠	kaui
𪢡	tfkk
𪢢	fkug
𪢣	fkue
𪢤	ktdk
𪢥	kthp
𪢦	sksh
𪢧	kbgn
𪢨	lyi
𪢩	lgig
𪢪	ludk
𪢫	llk
𪢬	ljxx
𪢭	luog
𪢮	lyos
𪢯	lahq
𪢰	lkmy
𪢱	fhu
𪢲	fcy
𪢳	fcnb
𪢴	ffg
𪢵	fmyy
𪢶	tff
𪢷	fynn
𪢸	ffqn
𪢹	fdmn
𪢺	fhcy
𪢻	feg
𪢼	fwxn
𪢽	fdhh
𪢾	off
𪢿	fiy
𪣀	fcn
𪣁	fcqn
𪣂	fbnn
𪣃	fgmw
𪣄	fdfj
𪣅	fann
𪣆	faiy
𪣇	ftpy
𪣈	fmkg
𪣉	fyni
𪣊	fntt
𪣋	fdhb
𪣌	fbg
𪣍	fjen
𪣎	friy
𪣏	fyth
𪣐	fyfg
𪣑	fpey
𪣒	fplh
𪣓	fnta
𪣔	fgkg
𪣕	fdqn
𪣖	svyf
𪣗	dfef
𪣘	fkgd
𪣙	fjug
𪣚	fjvg
𪣛	ftjh
𪣜	ften
𪣝	fran
𪣞	fpwa
𪣟	fpwf
𪣠	fykg
𪣡	itdf
𪣢	fiyy
𪣣	fvtk
𪣤	fajg
𪣥	fgah
𪣦	fjeg
𪣧	fjjg
𪣨	flfh
𪣩	fheg
𪣪	etaf
𪣫	fynj
𪣬	fpnn
𪣭	ihcf
𪣮	finx
𪣯	fpeg
𪣰	flah
𪣱	fuqh
𪣲	falg
𪣳	fdmf
𪣴	fght
𪣵	fuxe
𪣶	wtcf
𪣷	fqmd
𪣸	wtcf
𪣹	fyps
𪣺	fnwk
𪣻	fovg
𪣼	fyod
𪣽	cffb
𪣾	fcex
𪣿	btaf
𪤀	ahnf
𪤁	fgkf
𪤂	fhlg
𪤃	fjpv
𪤄	flfc
𪤅	fipq
𪤆	fynn
𪤇	fwyk
𪤈	temf
𪤉	fudi
𪤊	iyvf
𪤋	fybc
𪤌	fccs
𪤍	fnae
𪤎	flpy
𪤏	fadf
𪤐	ffxh
𪤑	flag
𪤒	fwgl
𪤓	ftxt
𪤔	fyny
𪤕	futg
𪤖	fnhf
𪤗	fnwe
𪤘	cfas
𪤙	ffoy
𪤚	fbud
𪤛	ftfn
𪤜	yyfy
𪤝	bjgf
𪤞	fnfp
𪤟	fmuf
𪤠	fflg
𪤡	fmau
𪤢	fkks
𪤣	fwgn
𪤤	fpyi
𪤥	fujn
𪤦	fgei
𪤧	fvgw	fwfw
𪤨	fthj
𪤩	fqmt
𪤪	fyjg	fyvf
𪤫	fobc
𪤬	dddf
𪤭	fhbh	fhwb
𪤮	fpdi
𪤯	fyjd
𪤰	ffss
𪤱	akfu
𪤲	fnqh
𪤳	fnkf
𪤴	fpgl
𪤵	tkib
𪤶	ghft
𪤷	qmhh
𪤸	qhqh
𪤹	qoy
𪤺	qqgn
𪤻	qqhc
𪤼	qyvb
𪤽	fwtq
𪤾	qfje
𪤿	qqff
𪥀	yylq
𪥁	dnb
𪥂	dvn
𪥃	fwsj
𪥄	sdu
𪥅	dat
𪥆	dwcu
𪥇	gmwd
𪥈	dguh
𪥉	gdcb
𪥊	fidy
𪥋	dfiu
𪥌	tmwd
𪥍	dgjn
𪥎	agdu
𪥏	dywy
𪥐	dwyh
𪥑	dfin	dfie
𪥒	kqwd
𪥓	dgmf
𪥔	pwad
𪥕	dnbm
𪥖	jand
𪥗	uejd
𪥘	ukhd	uskd
𪥙	rkad
𪥚	dufq
𪥛	ujnd
𪥜	dkka
𪥝	tgjd
𪥞	ugld
𪥟	ftgd
𪥠	mmmd
𪥡	bued
𪥢	oyod
𪥣	exdq
𪥤	hvf
𪥥	vthh
𪥦	vgxg
𪥧	vhg
𪥨	vjg
𪥩	vhcy
𪥪	vmmn
𪥫	vccy
𪥬	vcqn
𪥭	vmsh
𪥮	vhjg
𪥯	qhvc
𪥰	vpsh
𪥱	vgmi
𪥲	vtdc
𪥳	vkmh
𪥴	thvf
𪥵	vng
𪥶	vdtb
𪥷	wrvf
𪥸	qrvb
𪥹	vyme
𪥺	lalv
𪥻	vftp
𪥼	vgvv
𪥽	vdey
𪥾	vdqh
𪥿	vfnd
𪦀	vayn
𪦁	vtln
𪦂	vtmd
𪦃	vyhk
𪦄	vcjy
𪦅	vvlq
𪦆	vdpu
𪦇	vfff
𪦈	vajv
𪦉	viqy
𪦊	vkkn
𪦋	vwdc
𪦌	vuqv
𪦍	ynvq
𪦎	vute
𪦏	vxnn
𪦐	vvkt
𪦑	ahnv
𪦒	vhay
𪦓	vhna
𪦔	vwyk
𪦕	vwqq
𪦖	vups
𪦗	vdev
𪦘	vftt
𪦙	vatt
𪦚	vmty
𪦛	vpwd
𪦜	vifj
𪦝	vyby
𪦞	vnrg
𪦟	vbyu
𪦠	ccvf
𪦡	vgmi
𪦢	veqg
𪦣	vwtf
𪦤	vxxi
𪦥	xxvf
𪦦	vfqy
𪦧	vjdh
𪦨	vlqj
𪦩	vmxt
𪦪	vtln
𪦫	vutk
𪦬	vahm
𪦭	vdwo
𪦮	vlll
𪦯	vooy
𪦰	vgkk
𪦱	vooj
𪦲	vckm
𪦳	vjgq
𪦴	vtuj
𪦵	fhwv
𪦶	bfcy
𪦷	bat
𪦸	buy
𪦹	byy
𪦺	brg
𪦻	wgkb
𪦼	brqy
𪦽	ynab
𪦾	bnjw
𪦿	bwye
𪧀	bmmv
𪧁	blfh
𪧂	ahnb
𪧃	ybtf
𪧄	brcc
𪧅	pgmj
𪧆	pnyu
𪧇	pnhd
𪧈	plf
𪧉	pwer
𪧊	prkf
𪧋	pqvf
𪧌	pcsu
𪧍	pfqh
𪧎	pkhu
𪧏	plou
𪧐	pwrf
𪧑	pawu
𪧒	pwtk
𪧓	pirf
𪧔	pfjl
𪧕	pfrm
𪧖	prou
𪧗	pwwl
𪧘	povf
𪧙	pccv
𪧚	pbpf
𪧛	pdji
𪧜	pgqt
𪧝	paao
𪧞	pttu
𪧟	pnte
𪧠	pntg
𪧡	fhpf
𪧢	pfwy
𪧣	pati
𪧤	ptmt
𪧥	ppym
𪧦	pfji
𪧧	pgcf
𪧨	pjbc
𪧩	pmdv
𪧪	pvtl
𪧫	pdcu
𪧬	psgm
𪧭	pusr
𪧮	pcba
𪧯	ptha
𪧰	pgke
𪧱	pfjk
𪧲	pssc
𪧳	pswf
𪧴	pnlw
𪧵	ppgv
𪧶	pglj
𪧷	qfu
𪧸	ffwf
𪧹	uwgf
𪧺	jghf
𪧻	tmdf
𪧼	pwdf
𪧽	giff
𪧾	vfmy
𪧿	mwiy
𪨀	ibmh
𪨁	ebiy
𪨂	yogi
𪨃	iryf
𪨄	itwm
𪨅	itdy
𪨆	itoe
𪨇	gqkm
𪨈	dnkj
𪨉	ngmk
𪨊	nwwi
𪨋	ntfd
𪨌	nuav
𪨍	nwmc
𪨎	nylk
𪨏	nhie
𪨐	nyuy
𪨑	nylk
𪨒	nakf
𪨓	nymk
𪨔	nbhq
𪨕	ntfm
𪨖	ntfl
𪨗	nttj
𪨘	nqak
𪨙	ntff
𪨚	nuag
𪨛	nuaf
𪨜	nyth
𪨝	ntfj
𪨞	novh
𪨟	ntfj
𪨠	novf
𪨡	nfuh
𪨢	mghu
𪨣	mtnb
𪨤	imj
𪨥	mbn
𪨦	mrnn
𪨧	mwxb
𪨨	myhy
𪨩	mlnn
𪨪	mmmg
𪨫	mqtb
𪨬	myxy
𪨭	mxcy
𪨮	mxcu
𪨯	dnnm
𪨰	mmag
𪨱	miqb
𪨲	mrmj
𪨳	mtfh
𪨴	mriy
𪨵	rfcm
𪨶	mdlj
𪨷	mgod
𪨸	mkqw
𪨹	mkmw
𪨺	muwc
𪨻	mdlf
𪨼	mdfi
𪨽	muxf
𪨾	mepc
𪨿	myjn
𪩀	mnth
𪩁	mbeg
𪩂	mfmf
𪩃	mjgh
𪩄	mmtk
𪩅	mrgf
𪩆	mrhb
𪩇	movf
𪩈	mdtt
𪩉	mgef
𪩊	mldn
𪩋	mowv
𪩌	mxdm
𪩍	mgjf
𪩎	mmmv
𪩏	mynx
𪩐	mpwy
𪩑	mydn
𪩒	mnug
𪩓	magf
𪩔	muja
𪩕	mwxc
𪩖	mnbb
𪩗	mafr
𪩘	mfmd
𪩙	makf
𪩚	mwgj
𪩛	mdhb
𪩜	mqqc
𪩝	mugc
𪩞	mqaa
𪩟	mhbn	mhwn
𪩠	mgmx
𪩡	vcb
𪩢	rhkh
𪩣	daf
𪩤	angj
𪩥	anyk
𪩦	anss
𪩧	ypsn
𪩨	qlpn
𪩩	anup
𪩪	anww
𪩫	dwnb
𪩬	cqhh
𪩭	csww
𪩮	cfwt
𪩯	nutg
𪩰	magn
𪩱	cugi
𪩲	gmht
𪩳	mhgk
𪩴	mhug
𪩵	tfhh
𪩶	pwdh
𪩷	mhuf
𪩸	mhfm
𪩹	mhrf
𪩺	vpmw
𪩻	mhpj
𪩼	mheo
𪩽	mhhd
𪩾	ogwy
𪩿	mhjc
𪪀	wnns
𪪁	ffjh
𪪂	fjfh
𪪃	uagw
𪪄	guhn
𪪅	guhn
𪪆	guhn
𪪇	guhy
𪪈	djdf
𪪉	fuft
𪪊	xqyy
𪪋	xxft
𪪌	ygmh
𪪍	yyi
𪪎	yghd
𪪏	yhne
𪪐	yayi
𪪑	ytdj
𪪒	yvtk
𪪓	ygik
𪪔	ydcv
𪪕	yfcw
𪪖	ytfc
𪪗	yvcb
𪪘	ygkc
𪪙	yjgd
𪪚	ybkd
𪪛	yhag
𪪜	ywht
𪪝	yvkc
𪪞	yfuk
𪪟	ykkn
𪪠	ywfe
𪪡	ydum
𪪢	yujd
𪪣	ypgl
𪪤	yssg
𪪥	yudm
𪪦	ywho
𪪧	yxth
𪪨	yylo
𪪩	gayo
𪪪	yach
𪪫	akfl
𪪬	gfpk
𪪭	guhp
𪪮	lpd
𪪯	gvap
𪪰	uspd
𪪱	rgpd
𪪲	fgpd
𪪳	wcaj
𪪴	cfha
𪪵	fiya
𪪶	upma
𪪷	owva
𪪸	vdfa	qgva	wfva
𪪹	pela
𪪺	xkg
𪪻	xgmw
𪪼	xxxf
𪪽	xtlg
𪪾	xkhc
𪪿	xbcy
𪫀	xnhh
𪫁	xemf
𪫂	xpgw
𪫃	uxhm
𪫄	xwyc
𪫅	xqoo
𪫆	ivg
𪫇	xgom
𪫈	fkwe	gkhe
𪫉	utee
𪫊	gaeh
𪫋	tyy
𪫌	tdxn
𪫍	tfny
𪫎	tkty
𪫏	tkht
𪫐	tqky
𪫑	tlge
𪫒	thpx
𪫓	tvfh
𪫔	tqdy
𪫕	txty
𪫖	tgjf
𪫗	tiqf
𪫘	thkh
𪫙	tlff
𪫚	ifch
𪫛	tsse
𪫜	tbmt
𪫝	ngnn
𪫞	nfg
𪫟	nsy
𪫠	xxnu
𪫡	ndln
𪫢	nhbh
𪫣	nhg
𪫤	ncqn
𪫥	xhnu
𪫦	ndag
𪫧	nskg
𪫨	naqy
𪫩	hnu
𪫪	nmkg
𪫫	wvyn
𪫬	nygg
𪫭	nftn
𪫮	ndjg
𪫯	naoy
𪫰	kknu
𪫱	wwvn
𪫲	npvg
𪫳	yenu
𪫴	vnnu
𪫵	gany
𪫶	wynh
𪫷	dtfn
𪫸	nfcb
𪫹	nwwk
𪫺	nwgi
𪫻	npfq
𪫼	yfnu
𪫽	binu
𪫾	vrnu
𪫿	napy
𪬀	ntln
𪬁	ntfx
𪬂	pynn
𪬃	npeg
𪬄	uxhn
𪬅	pdnu
𪬆	ytnu
𪬇	dhdt
𪬈	gkin
𪬉	nsfg
𪬊	hqrn
𪬋	mnmn
𪬌	njcl
𪬍	nhkn	nhky
𪬎	qvnc
𪬏	ntjg
𪬐	uthn
𪬑	nnga
𪬒	vctn
𪬓	sifn
𪬔	ngqi
𪬕	ngcj
𪬖	nuwy
𪬗	ntgf	ntff
𪬘	nuwl
𪬙	nike
𪬚	nprw
𪬛	pwwn
𪬜	nyod
𪬝	nugn
𪬞	nnhg
𪬟	ssen
𪬠	nakk
𪬡	njcm
𪬢	njhl
𪬣	nrnk
𪬤	thnt
𪬥	umwn
𪬦	npgw
𪬧	nnyi
𪬨	njgf
𪬩	kmln
𪬪	whwn
𪬫	ujnh
𪬬	igen
𪬭	nnwh
𪬮	nbkg
𪬯	gkin
𪬰	nhxe
𪬱	nlkm
𪬲	wvne
𪬳	ynnm
𪬴	usrn
𪬵	vfjn	vhtn
𪬶	nxtu
𪬷	ngjf
𪬸	nuto
𪬹	nylj
𪬺	nptl
𪬻	ntmt
𪬼	wvnm
𪬽	qvnk
𪬾	noqb
𪬿	gegn
𪭀	ujun	uytn
𪭁	fpgn
𪭂	ujdn
𪭃	ngnl	nfll
𪭄	nptm
𪭅	afan
𪭆	nuht
𪭇	nugy
𪭈	nmmy
𪭉	agf
𪭊	alv
𪭋	fabd
𪭌	alf
𪭍	awat
𪭎	atld
𪭏	davt
𪭐	aebd
𪭑	amhh
𪭒	faeb
𪭓	hlat
𪭔	depa
𪭕	iada
𪭖	xgua
𪭗	xyxt
𪭘	ynan
𪭙	ynmk
𪭚	ynjh
𪭛	ynaj
𪭜	rqy
𪭝	rfnh
𪭞	rtxy
𪭟	rtfh
𪭠	rqwy
𪭡	rwfh
𪭢	rwwy
𪭣	rnny
𪭤	rghg
𪭥	rdag
𪭦	rkqn
𪭧	rqiy
𪭨	rtdy
𪭩	rway
𪭪	rmmg
𪭫	rsyn
𪭬	rdmh
𪭭	rrqa
𪭮	rwww
𪭯	rwfc
𪭰	rudh
𪭱	runw
𪭲	rcdh
𪭳	rvey
𪭴	rfhy
𪭵	rgmw
𪭶	rkkh
𪭷	rksy
𪭸	rkuf
𪭹	rvqn
𪭺	rqfy
𪭻	rrhg
𪭼	rtjh
𪭽	ryfy
𪭾	rueg
𪭿	rnhf
𪮀	rbfq
𪮁	rgmj
𪮂	rgub
𪮃	lrrj
𪮄	rhvv
𪮅	rtsy
𪮆	rrag
𪮇	rqnk
𪮈	rwgq
𪮉	rydh
𪮊	ryof
𪮋	rvij
𪮌	rycj
𪮍	rafs
𪮎	rayx
𪮏	rlny
𪮐	rkkk
𪮑	rrhg
𪮒	rrhg
𪮓	rtda
𪮔	ritk
𪮕	rnuh	rnuj
𪮖	rxqc
𪮗	rdft
𪮘	rmth
𪮙	raaw
𪮚	mumr
𪮛	rjff
𪮜	rtgf	rtff
𪮝	rtkl
𪮞	rtrw
𪮟	rwqq
𪮠	ryon
𪮡	ryve
𪮢	rdri
𪮣	rfcr
𪮤	rmee
𪮥	rtek
𪮦	rtjf
𪮧	ryvh
𪮨	rips
𪮩	roeg
𪮪	rnfy
𪮫	rajt
𪮬	rfkk
𪮭	rfhi
𪮮	rhja
𪮯	rkbh
𪮰	runy
𪮱	rqje
𪮲	rugw
𪮳	ryoj
𪮴	rnov
𪮵	rgxw
𪮶	rgkm
𪮷	rwgu
𪮸	rsdp
𪮹	rtdh
𪮺	rvhl
𪮻	rlrj
𪮼	rtgo
𪮽	rrrm
𪮾	ryns
𪮿	rynt
𪯀	rlkc
𪯁	rnay
𪯂	rywn
𪯃	raue
𪯄	rakl
𪯅	odfc
𪯆	fcff
𪯇	lgcc
𪯈	fwty
𪯉	tghc
𪯊	nhth
𪯋	guwc
𪯌	wnnt
𪯍	gjqt
𪯎	fuft
𪯏	qrnt
𪯐	upmt
𪯑	gxit
𪯒	yptt
𪯓	gmat
𪯔	umwt
𪯕	ytwf
𪯖	nwet
𪯗	aetv
𪯘	aqat
𪯙	upmt
𪯚	ntft
𪯛	ytgi
𪯜	ylkt
𪯝	aets
𪯞	ytdf
𪯟	kkht
𪯠	ykj
𪯡	khyu
𪯢	yyy	aya
𪯣	ylf
𪯤	ywgk
𪯥	ggyu
𪯦	ymaw
𪯧	yqg
𪯨	utpv
𪯩	ywyc
𪯪	yymk
𪯫	ufrg
𪯬	rgkf
𪯭	adjf
𪯮	kylf
𪯯	dhwf
𪯰	wtuc
𪯱	rty
𪯲	yrh
𪯳	ytcy
𪯴	yhkg
𪯵	agyn
𪯶	yrdy
𪯷	yudh
𪯸	ytrg
𪯹	ydey
𪯺	ywyn
𪯻	ypgh
𪯼	yyjg	yyjf
𪯽	ythc
𪯾	ykmy
𪯿	yamy
𪰀	yrla
𪰁	ywya
𪰂	yxjm
𪰃	ytaf
𪰄	ytja
𪰅	ytqb
𪰆	jag
𪰇	jqhh
𪰈	jfqn
𪰉	jfjh
𪰊	jhf
𪰋	jty
𪰌	jtfn
𪰍	jufh
𪰎	yjf
𪰏	jskg
𪰐	jsgg
𪰑	jgyu
𪰒	jdg
𪰓	jguh
𪰔	jmdu
𪰕	jtdy
𪰖	jtdu
𪰗	jntt
𪰘	jlkf
𪰙	jfkg
𪰚	jftx
𪰛	ffjg
𪰜	jaag
𪰝	jahj
𪰞	jafj
𪰟	jrhf
𪰠	jtah
𪰡	jwgg
𪰢	jyth
𪰣	jng
𪰤	jivg
𪰥	jgkg
𪰦	jwwf
𪰧	jpdc
𪰨	jnyn
𪰩	janx
𪰪	jsww
𪰫	jdfa
𪰬	jgtj
𪰭	jqvh
𪰮	jrmj
𪰯	jghc
𪰰	jffh
𪰱	jght
𪰲	jdjb
𪰳	jdhd
𪰴	jwdc
𪰵	jcll
𪰶	jxjm
𪰷	jvfp
𪰸	jgxi
𪰹	jfjf
𪰺	jlwt
𪰻	jwyk
𪰼	jyvk
𪰽	jylh
𪰾	jghj
𪰿	jghb
𪱀	jlxi
𪱁	jqrf
𪱂	jqtj
𪱃	jtxt
𪱄	jpgw
𪱅	jifj
𪱆	jjfe
𪱇	jgjn
𪱈	jjjj
𪱉	jasw
𪱊	jtgk
𪱋	judk
𪱌	jool
𪱍	jujn
𪱎	jtgj
𪱏	jqmt
𪱐	ujih
𪱑	jdjf
𪱒	jyke
𪱓	joyc
𪱔	jvtq	jwfq
𪱕	jbch
𪱖	jwyw
𪱗	uljn
𪱘	maev
𪱙	ecy
𪱚	ehg
𪱛	vted	vtef
𪱜	ckeg
𪱝	bief
𪱞	afed
𪱟	gjge	gyte
𪱠	egoc
𪱡	ewfi
𪱢	ethj
𪱣	emun
𪱤	dett
𪱥	efam
𪱦	ergg
𪱧	eypm
𪱨	eujn
𪱩	eybc
𪱪	eudo
𪱫	qkxe
𪱬	eief
𪱭	eyoe
𪱮	ynem
𪱯	ynen
𪱰	deyf
𪱱	sghu
𪱲	shg
𪱳	skg
𪱴	svg
𪱵	vsu
𪱶	fjsi
𪱷	smy
𪱸	swuy
𪱹	siy
𪱺	sdag
𪱻	ssgg
𪱼	fiwn
𪱽	seh
𪱾	sqiy
𪱿	stbg
𪲀	srgg
𪲁	uqsu
𪲂	sjnn	snjg
𪲃	sadg
𪲄	sdoy
𪲅	figh
𪲆	sdnf
𪲇	smag
𪲈	shhg
𪲉	srgk
𪲊	smyy
𪲋	stfh
𪲌	symy
𪲍	sumh
𪲎	syjh
𪲏	sxty
𪲐	sgqb
𪲑	gbsu
𪲒	sfoy
𪲓	sgku
𪲔	sgmy
𪲕	gmic
𪲖	sksy
𪲗	sloy
𪲘	strt
𪲙	staf
𪲚	sieg
𪲛	sonn
𪲜	uwys
𪲝	sysy
𪲞	sudn
𪲟	sfuf
𪲠	gvws
𪲡	ssfc
𪲢	spyn
𪲣	afsh
𪲤	smqb
𪲥	gkic
𪲦	sitr
𪲧	swwh
𪲨	sqrn
𪲩	spjg
𪲪	ylks
𪲫	ubts
𪲬	ymho
𪲭	sybq
𪲮	syny
𪲯	sveh
𪲰	sqmd
𪲱	syod
𪲲	sdkc
𪲳	syms
𪲴	sdks
𪲵	ssbm
𪲶	sftk
𪲷	slsy
𪲸	gmii
𪲹	jtys
𪲺	sjqb
𪲻	srdf
𪲼	swyg
𪲽	qsrr
𪲾	sesk
𪲿	udgi
𪳀	sujg
𪳁	syac
𪳂	suth
𪳃	spvm
𪳄	sypm
𪳅	sitk
𪳆	scel
𪳇	slkp
𪳈	gams
𪳉	ssny
𪳊	sdes
𪳋	sgnn
𪳌	sfel
𪳍	sbcc
𪳎	bosu
𪳏	skky
𪳐	hhsu
𪳑	sjoy
𪳒	sjiq
𪳓	keys
𪳔	riwa
𪳕	stux
𪳖	stap
𪳗	sepc
𪳘	spge
𪳙	uwys
𪳚	spgi
𪳛	svfj
𪳜	sbio
𪳝	ssgo
𪳞	sftt
𪳟	ssqq
𪳠	shxr
𪳡	smhx
𪳢	smfg
𪳣	shmk
𪳤	stfp
𪳥	sqjn
𪳦	wnns
𪳧	sqdb	sdqb	sddb
𪳨	pwfs
𪳩	syhq
𪳪	sihv
𪳫	cccm
𪳬	snfy
𪳭	fwfi
𪳮	sfpu
𪳯	ssif
𪳰	sajs
𪳱	skhh
𪳲	stdj
𪳳	sthx
𪳴	smlc
𪳵	seto
𪳶	spfu
𪳷	ijgs
𪳸	suef
𪳹	sbue
𪳺	slkm
𪳻	scbs
𪳼	ifti
𪳽	ssdl
𪳾	sfal
𪳿	jsyc
𪴀	smau
𪴁	skhq
𪴂	sjly
𪴃	stmd
𪴄	rifb
𪴅	stgh
𪴆	suxn
𪴇	syno
𪴈	scbs
𪴉	sxxt
𪴊	sgmu
𪴋	skak
𪴌	stpn
𪴍	oyms
𪴎	spxm
𪴏	sbjc
𪴐	sfvp
𪴑	sddj
𪴒	rrcy	srcy
𪴓	stjy
𪴔	spdi
𪴕	snuj
𪴖	sfss
𪴗	suxw
𪴘	sjfc
𪴙	stfm
𪴚	stgo
𪴛	ssfi
𪴜	sfsh
𪴝	sqoj
𪴞	rise
𪴟	sfcl
𪴠	sfdp
𪴡	stji
𪴢	sdhh
𪴣	spwm
𪴤	svqq	swfq
𪴥	spgm
𪴦	sysf
𪴧	stui
𪴨	oguw	ogow
𪴩	yqwy
𪴪	dfqw
𪴫	nfqw
𪴬	xtgw
𪴭	rcqw
𪴮	ajqw
𪴯	jogw
𪴰	adkw
𪴱	wcnw
𪴲	ndjw
𪴳	awww
𪴴	ugow
𪴵	qrhf
𪴶	hgjg
𪴷	hceh
𪴸	hfnt
𪴹	ghic
𪴺	swwh
𪴻	gigk
𪴼	hdat
𪴽	gigt
𪴾	lyhg
𪴿	vgnh	wfgh
𪵀	gqqn
𪵁	gqbc
𪵂	gqyb
𪵃	gqvq
𪵄	gqhq
𪵅	gqwa
𪵆	gqfw
𪵇	gqgm
𪵈	dfnc
𪵉	kfmc
𪵊	xtdt
𪵋	ftbc
𪵌	mcwq
𪵍	wgkc
𪵎	cbmc
𪵏	utec
𪵐	gehc
𪵑	fnmj
𪵒	ajmc
𪵓	ngcc
𪵔	txgi
𪵕	xxwm
𪵖	tfnn
𪵗	tfne
𪵘	tfno
𪵙	tfnk
𪵚	tfnx
𪵛	tfni
𪵜	tfnd
𪵝	sstn
𪵞	tfni
𪵟	tfnh
𪵠	tfnw
𪵡	tfnx
𪵢	tfnm
𪵣	fcrn
𪵤	rnsk
𪵥	rntu
𪵦	ujrn
𪵧	rngt
𪵨	ciu
𪵩	ighy
𪵪	diu
𪵫	iay
𪵬	itmn
𪵭	idgn
𪵮	irj
𪵯	iet
𪵰	ixhh
𪵱	iddn
𪵲	immg
𪵳	itdy
𪵴	itmh
𪵵	ynie
𪵶	inln
𪵷	iafg
𪵸	ifbn
𪵹	iabh
𪵺	ihqy
𪵻	itlw
𪵼	iqcb
𪵽	iccc
𪵾	iskg
𪵿	sriy
𪶀	illn
𪶁	imgg
𪶂	ihqb
𪶃	iklj
𪶄	ijfy
𪶅	iwfi
𪶆	iqto
𪶇	itdf
𪶈	ionn
𪶉	ipwl
𪶊	iyfy
𪶋	ivit
𪶌	igcj
𪶍	igdh
𪶎	irvk
𪶏	ifch
𪶐	imdf
𪶑	ilnt
𪶒	ilqy
𪶓	itmd
𪶔	iwff
𪶕	iobh
𪶖	iblg
𪶗	ifaf
𪶘	ibbh
𪶙	idff
𪶚	ifin
𪶛	shiu
𪶜	irua
𪶝	igck
𪶞	imhd
𪶟	imcw
𪶠	iwct
𪶡	iwgn
𪶢	iwwt
𪶣	itla
𪶤	iwuy
𪶥	ingg
𪶦	iyey
𪶧	iyob
𪶨	ivcn
𪶩	ickn
𪶪	isgn
𪶫	idwy
𪶬	iadd
𪶭	igqo
𪶮	igon
𪶯	isdj
𪶰	deiu
𪶱	imuh
𪶲	iald
𪶳	iqku	iqju
𪶴	iewj
𪶵	itrw
𪶶	iywf
𪶷	ipwq
𪶸	iyxi
𪶹	iytp
𪶺	iyoy
𪶻	iuqe
𪶼	iitk
𪶽	iccs
𪶾	ibgn
𪶿	ixtw
𪷀	ifir
𪷁	imgt	imtt
𪷂	ajdi
𪷃	ijcq
𪷄	ieuq
𪷅	ipoo
𪷆	ipju
𪷇	iuev
𪷈	ixfm
𪷉	ixlg
𪷊	inug
𪷋	iftf
𪷌	idmo
𪷍	igeq
𪷎	iamt	ighm
𪷏	idgf
𪷐	iahy
𪷑	ijgf
𪷒	iaqm
𪷓	ihal
𪷔	imcq
𪷕	idjy
𪷖	iqdo
𪷗	ierf
𪷘	irmr
𪷙	iuqg
𪷚	ipwh
𪷛	ipgl
𪷜	ixxi
𪷝	idyx
𪷞	iajl
𪷟	iope
𪷠	iaec
𪷡	ijkr
𪷢	ikgm
𪷣	wnni
𪷤	iyli
𪷥	iuft
𪷦	iplp
𪷧	ivtd
𪷨	iahn
𪷩	idjs
𪷪	ifnm
𪷫	igei
𪷬	iahi
𪷭	iuff
𪷮	itfk	itfd
𪷯	iopi
𪷰	iujk
𪷱	ipfm
𪷲	iyaf
𪷳	ifih
𪷴	ifwo
𪷵	iabc
𪷶	iexc
𪷷	ipdi
𪷸	iynt
𪷹	ujnk
𪷺	iagn
𪷻	iqaa
𪷼	iqdk
𪷽	itfm
𪷾	itxg	itmg
𪷿	ixfm
𪸀	ifnc
𪸁	iyac
𪸂	ioyc
𪸃	igeo
𪸄	iahh
𪸅	iqyi
𪸆	iqpk
𪸇	iynf
𪸈	ilff
𪸉	iqoi
𪸊	iqvq
𪸋	ipfc
𪸌	iunu
𪸍	nou
𪸎	otmn
𪸏	otnn
𪸐	ovyy
𪸑	ofqn
𪸒	ogxg
𪸓	fqou
𪸔	ohg
𪸕	ornn
𪸖	opwu
𪸗	ocqn
𪸘	ofcy
𪸙	ofiy
𪸚	odkg
𪸛	ogyy
𪸜	olwy
𪸝	okln
𪸞	oqiy
𪸟	oqhy
𪸠	oyni
𪸡	oxcy
𪸢	onhy
𪸣	jou
𪸤	odnt
𪸥	obg
𪸦	ftxo
𪸧	okmh
𪸨	oesy
𪸩	oplh
𪸪	ong
𪸫	ogjq
𪸬	oakg
𪸭	omy
𪸮	ojdy
𪸯	oevg
𪸰	otlk
𪸱	oyfy
𪸲	ocvk
𪸳	orvk
𪸴	odsk
𪸵	ogah
𪸶	oaat
𪸷	ofwf
𪸸	omaw
𪸹	ohet
𪸺	ojqb
𪸻	ojyy	ojyc
𪸼	omfk
𪸽	owgf
𪸾	oqvh
𪸿	ybou
𪹀	poch
𪹁	oblg
𪹂	vocf
𪹃	vkbo
𪹄	ogmn
𪹅	odmf
𪹆	odae
𪹇	omdo
𪹈	ojgh
𪹉	qvmo
𪹊	owgj
𪹋	otky
𪹌	qlqo
𪹍	ownd
𪹎	opfe
𪹏	ougd
𪹐	oqko
𪹑	vkoo
𪹒	odaj
𪹓	ogoj
𪹔	ogtk
𪹕	jqjo
𪹖	omdt
𪹗	evoy
𪹘	otwt
𪹙	otec
𪹚	oupy
𪹛	oube
𪹜	oylh
𪹝	oofo
𪹞	opuh
𪹟	ovmy
𪹠	ocwy
𪹡	osse
𪹢	okht
𪹣	ohag
𪹤	oqsc
𪹥	owfi
𪹦	olou
𪹧	oumd
𪹨	oyvh
𪹩	xjxo
𪹪	ogfn	oghn
𪹫	ofke
𪹬	kkao
𪹭	mhko
𪹮	tfno
𪹯	owys
𪹰	oycy	oywy
𪹱	ybdo
𪹲	oyct
𪹳	onty
𪹴	odap
𪹵	ossh
𪹶	jfto
𪹷	ojfe
𪹸	qsgo
𪹹	oujn
𪹺	oodm
𪹻	ovas
𪹼	ojan
𪹽	oopk
𪹾	opwi
𪹿	pgio
𪺀	onyf
𪺁	oflm
𪺂	syso
𪺃	oqnf
𪺄	oelb
𪺅	opdn
𪺆	oelb
𪺇	oyby
𪺈	oght
𪺉	ohad
𪺊	olkp
𪺋	ttxo	ttmo
𪺌	oipf
𪺍	evf
𪺎	rhyq
𪺏	eeu
𪺐	rhyc
𪺑	whye	rhye
𪺒	ehtu
𪺓	qvhs
𪺔	epqe
𪺕	exxx
𪺖	rhyh
𪺗	qvhq
𪺘	qvhm
𪺙	exty
𪺚	eqoo
𪺛	wqrm
𪺜	wqvb
𪺝	qqrh
𪺞	nhdy
𪺟	nhdl
𪺠	nhdn
𪺡	nhdl
𪺢	thge
𪺣	thgf
𪺤	thgj
𪺥	thgn
𪺦	thgj
𪺧	ahtw
𪺨	ahtf
𪺩	trta
𪺪	trdx
𪺫	verh
𪺬	trvj
𪺭	trtj
𪺮	ycph
𪺯	troo
𪺰	trgl
𪺱	trff
𪺲	trgf
𪺳	tqth
𪺴	trah
𪺵	trdn
𪺶	awnh
𪺷	qtwb
𪺸	qtqv
𪺹	qtvc
𪺺	qtlt
𪺻	qtpe
𪺼	qtde
𪺽	gody
𪺾	qtdf
𪺿	qtug
𪻀	qtwa
𪻁	qtug
𪻂	qtrh
𪻃	qtth
𪻄	qtud
𪻅	qtcm
𪻆	qtrc
𪻇	qttk
𪻈	qtxj
𪻉	qtyy
𪻊	qtfe
𪻋	qtyf
𪻌	qtli
𪻍	gcy
𪻎	gqug
𪻏	geyy
𪻐	gwwy
𪻑	gymn
𪻒	gny
𪻓	goy
𪻔	gpqn
𪻕	gdg
𪻖	gwfn
𪻗	gdfg
𪻘	ggjg
𪻙	gaag
𪻚	gaqy
𪻛	gmgk
𪻜	gwsy
𪻝	gpgf
𪻞	gynw
𪻟	gndh
𪻠	ggah
𪻡	ggku
𪻢	grrh
𪻣	gmwk
𪻤	grgw
𪻥	gybh
𪻦	gdfi
𪻧	gfwf
𪻨	gfnd
𪻩	gsrh
𪻪	gjeg
𪻫	gmun
𪻬	grgm
𪻭	gpgg
𪻮	gogg
𪻯	gyty
𪻰	gcqt
𪻱	gbib
𪻲	gxfm
𪻳	gfmf
𪻴	ggwe
𪻵	gdjf
𪻶	gdjb
𪻷	gadk
𪻸	gask
𪻹	jtgy
𪻺	gkhm
𪻻	gith
𪻼	grsy
𪻽	gptk
𪻾	gute
𪻿	gyac
𪼀	guph
𪼁	gyod
𪼂	guty
𪼃	gdwi
𪼄	gfke
𪼅	gepy
𪼆	gdri
𪼇	gmth
𪼈	wggg
𪼉	wgkg
𪼊	gtfh
𪼋	gttn
𪼌	gwyc
𪼍	gpwg
𪼎	gudc
𪼏	gccs
𪼐	gdqq
𪼑	gahf
𪼒	gapq
𪼓	glag
𪼔	gwge
𪼕	gytd
𪼖	gpvw
𪼗	gfyy
𪼘	gapg
𪼙	gugg
𪼚	gjqq
𪼛	gwys
𪼜	gwgn
𪼝	gyin
𪼞	guaj
𪼟	gnih
𪼠	gwxc
𪼡	gglg
𪼢	glff
𪼣	gtmd
𪼤	gqdy
𪼥	gyuo
𪼦	gujn
𪼧	gawk
𪼨	gpxe
𪼩	gddj
𪼪	gted
𪼫	gulb
𪼬	gfss
𪼭	gpdn
𪼮	gple
𪼯	gugt
𪼰	gvgr	gwfr
𪼱	gygm
𪼲	gipo
𪼳	rcyd
𪼴	rcyy
𪼵	duxy
𪼶	gnyn
𪼷	gnyg
𪼸	gnyo
𪼹	gnyg
𪼺	kman
𪼻	gnyw
𪼼	gnyh
𪼽	wwwn
𪼾	wwkn
𪼿	gnyv
𪽀	tfkf
𪽁	tghy
𪽂	dttg	gttg
𪽃	tgdh
𪽄	tgik
𪽅	yqag
𪽆	tmfh
𪽇	lvn
𪽈	lnrt
𪽉	mgeu
𪽊	lfqn
𪽋	elf
𪽌	lyy
𪽍	lskf
𪽎	lskg
𪽏	lwyc
𪽐	tlwj
𪽑	lqrh
𪽒	lycq
𪽓	ldkh
𪽔	lhqn
𪽕	qnll
𪽖	vfbl
𪽗	nygb
𪽘	lfwf
𪽙	ldwh
𪽚	wwal
𪽛	nawl
𪽜	lnhc
𪽝	lfcm
𪽞	ujnl
𪽟	lqou
𪽠	riqm
𪽡	ctol
𪽢	lwyo
𪽣	pujl
𪽤	lllg
𪽥	lxxu
𪽦	lugt
𪽧	rgkh
𪽨	ugqi
𪽩	uwev
𪽪	utay
𪽫	urhy
𪽬	ufii
𪽭	uge
𪽮	uhne
𪽯	uxhj
𪽰	ukhi
𪽱	upwl
𪽲	ugmd
𪽳	usvd
𪽴	uanm
𪽵	ubry
𪽶	ugkh
𪽷	ugun
𪽸	ufht
𪽹	ubjy
𪽺	udjq
𪽻	rsy
𪽼	ryy
𪽽	rrgg
𪽾	rmu
𪽿	rqkq
𪾀	rakg
𪾁	rifc
𪾂	rgkq
𪾃	rnhh
𪾄	rrvc
𪾅	rugt
𪾆	hcqh
𪾇	hcty
𪾈	hcsv
𪾉	hcbb
𪾊	dnlf
𪾋	jclf
𪾌	sklf
𪾍	kqlf
𪾎	qblf
𪾏	hlnl
𪾐	qkql
𪾑	rqnl
𪾒	itul
𪾓	fdnl
𪾔	edml
𪾕	eudl
𪾖	lwvo
𪾗	wprl	wyvl
𪾘	qxxl
𪾙	vtll	qgtl	wftl
𪾚	ovpl
𪾛	inhl
𪾜	lful
𪾝	telt
𪾞	xnjl
𪾟	hgng
𪾠	hqyy
𪾡	hdnn
𪾢	hmqn
𪾣	hpgg
𪾤	hdnt
𪾥	hkgn
𪾦	hhnt
𪾧	hwyc
𪾨	hkfn
𪾩	hpgf
𪾪	huqw
𪾫	hegl
𪾬	htdn
𪾭	hssy
𪾮	hetf
𪾯	hrqw
𪾰	hyty
𪾱	hith
𪾲	hujg
𪾳	hnhh
𪾴	hnoy
𪾵	hgxi
𪾶	htgf	htff
𪾷	hwye
𪾸	hprw
𪾹	haqh
𪾺	pnth
𪾻	iwyh
𪾼	hfpu
𪾽	huyy
𪾾	htwk
𪾿	huoj
𪿀	hpjy
𪿁	ujnh
𪿂	tmgh
𪿃	rhvf
𪿄	htun
𪿅	hywo
𪿆	cbtr
𪿇	cbte
𪿈	tdsy
𪿉	tdit
𪿊	tdgg
𪿋	tdaw
𪿌	tdcs
𪿍	tdkj
𪿎	tdtf
𪿏	tdga
𪿐	tdlj
𪿑	dfqn
𪿒	dhbh
𪿓	dxgg
𪿔	daqn
𪿕	dqkg
𪿖	dyxy
𪿗	dnxn
𪿘	dckg
𪿙	ddoy
𪿚	dffy
𪿛	djy
𪿜	dpwn
𪿝	iwdf
𪿞	ddtf
𪿟	ddfe
𪿠	dkeg
𪿡	dpwf
𪿢	duh
𪿣	dvfb
𪿤	ddqn
𪿥	dsty
𪿦	dgey
𪿧	driy
𪿨	ddjd
𪿩	dndg
𪿪	drdf
𪿫	dcuq
𪿬	ddun
𪿭	dpey
𪿮	dpwk
𪿯	depy
𪿰	dwfw
𪿱	dtel
𪿲	dpwm
𪿳	dyss
𪿴	dutg
𪿵	dfwl
𪿶	ddhi
𪿷	dpnh
𪿸	dddh
𪿹	dhby
𪿺	dtuh
𪿻	dahu
𪿼	dbci
𪿽	dria
𪿾	datl
𪿿	dedt
𫀀	gcfi
𫀁	pyvg
𫀂	fwfi	ftyi
𫀃	pymw
𫀄	dfit
𫀅	pyhk
𫀆	pyqn
𫀇	pydi
𫀈	pymk
𫀉	pytl
𫀊	pyye
𫀋	pydw
𫀌	pygy
𫀍	pyjt	pyjy
𫀎	pyyg
𫀏	pypq
𫀐	pygh
𫀑	pyhj
𫀒	pyjr
𫀓	pykn
𫀔	pyqs
𫀕	pyvn
𫀖	pyrq
𫀗	pyvq
𫀘	pyvi
𫀙	pyct
𫀚	pyjl
𫀛	pybb
𫀜	dwti
𫀝	jlfi	jegi	jmgi
𫀞	pywk
𫀟	pynt
𫀠	pyih
𫀡	pytc
𫀢	pymc
𫀣	pytw
𫀤	pykt
𫀥	ybmj
𫀦	tyi	tyu	tsyi	tsyu
𫀧	taf
𫀨	tmqn
𫀩	ttfh
𫀪	tlg
𫀫	tmtn
𫀬	tqvg
𫀭	tvah
𫀮	tivg
𫀯	tvjg
𫀰	tiqb
𫀱	trgk
𫀲	tdqn
𫀳	dqgt
𫀴	tjfg
𫀵	tpgn
𫀶	tpfq
𫀷	tvyn
𫀸	tnnk
𫀹	tjeg
𫀺	tqtt
𫀻	tyvw
𫀼	tlny
𫀽	tjmy
𫀾	trit
𫀿	txey
𫁀	tvfp
𫁁	tkhl
𫁂	tlfc
𫁃	tetl
𫁄	tiie
𫁅	hmtc
𫁆	tfol
𫁇	trie
𫁈	tujn
𫁉	temq
𫁊	pwyn
𫁋	pwmk
𫁌	pwgf
𫁍	pwri
𫁎	pwan
𫁏	pwwt
𫁐	pwvt
𫁑	pwkn
𫁒	pwwy
𫁓	pwwb
𫁔	pwag
𫁕	pwql
𫁖	pwrc
𫁗	pwrm
𫁘	pwkv	pwxf
𫁙	pwqv
𫁚	pwqf
𫁛	pwaa
𫁜	pwdq
𫁝	pwtk
𫁞	uqhh
𫁟	ufny
𫁠	ummg
𫁡	uqyg
𫁢	upgf
𫁣	uqeh
𫁤	uvug
𫁥	uyhk
𫁦	undg
𫁧	utff
𫁨	unhh
𫁩	ujng
𫁪	uuuf
𫁫	ubth
𫁬	utjr
𫁭	uool
𫁮	gwmu
𫁯	ujtb
𫁰	thu
𫁱	tbgf
𫁲	tfqb
𫁳	tfnh
𫁴	tuwu
𫁵	tufj
𫁶	tnyu
𫁷	tccu
𫁸	tdnt
𫁹	tamh
𫁺	togf
𫁻	twbf
𫁼	tmhy
𫁽	tnyw
𫁾	teu
𫁿	tlj
𫂀	tfpb
𫂁	tjdu
𫂂	ttxu
𫂃	tuyu
𫂄	tlnb
𫂅	trxj
𫂆	tlgy
𫂇	trqy
𫂈	tyny
𫂉	tvcb
𫂊	tsgh
𫂋	tafs
𫂌	tlwn
𫂍	tkjj
𫂎	tqjd
𫂏	tovy
𫂐	tdwi
𫂑	tdun
𫂒	tgri
𫂓	tftj
𫂔	tldt
𫂕	twuk
𫂖	tepc
𫂗	topu
𫂘	tssg
𫂙	tgkt
𫂚	tstu
𫂛	tlki
𫂜	thmc
𫂝	tqmq	tqmt
𫂞	tyvi
𫂟	tyss
𫂠	tgjn
𫂡	tgmi
𫂢	tdwm
𫂣	tade
𫂤	tqje
𫂥	tglm
𫂦	tpyi
𫂧	tgki
𫂨	tffl
𫂩	tmgh
𫂪	ttdv
𫂫	tbuf
𫂬	ttqh
𫂭	teuy
𫂮	tadn
𫂯	tyny
𫂰	tfag
𫂱	tohk	tohh
𫂲	eou
𫂳	mou
𫂴	obn
𫂵	ojf
𫂶	odhh
𫂷	oqfh	otyf
𫂸	oamh
𫂹	odg
𫂺	olg
𫂻	ohjg
𫂼	oqiy
𫂽	oadt
𫂾	oldy
𫂿	qsou
𫃀	opvg
𫃁	ofiy
𫃂	obcy
𫃃	orgb
𫃄	owcn
𫃅	oylk
𫃆	jgho
𫃇	okbg
𫃈	ovhn
𫃉	sogn
𫃊	oafx
𫃋	oqfh
𫃌	onae
𫃍	oyvh
𫃎	oyss
𫃏	ojyi
𫃐	ouny
𫃑	oool
𫃒	oaan
𫃓	omnp
𫃔	ohkb
𫃕	ouxn
𫃖	otvb
𫃗	ofno
𫃘	olaf
𫃙	lony
𫃚	xhy
𫃛	txnv	txnn	mxi
𫃜	xkg
𫃝	xwnn
𫃞	xkhh
𫃟	xfiy
𫃠	xqnn
𫃡	xug
𫃢	xwsy
𫃣	xpbg
𫃤	xivg
𫃥	xkhy
𫃦	xegc
𫃧	xqjn
𫃨	xujn
𫃩	xvnf
𫃪	xgbu
𫃫	xdah
𫃬	xhic
𫃭	xegd
𫃮	xtyg
𫃯	xveh
𫃰	xcdd
𫃱	xvgi
𫃲	xvph
𫃳	xjqy
𫃴	xqmd
𫃵	xovg
𫃶	xitk
𫃷	xnhg
𫃸	xrev
𫃹	xiqp
𫃺	xggj	xgjh	xthh
𫃻	xpwk
𫃼	xouf
𫃽	xfvg
𫃾	xagy
𫃿	xefy
𫄀	xpff
𫄁	xaje
𫄂	xtvh
𫄃	xybt
𫄄	xnov
𫄅	xdgn
𫄆	xdyf
𫄇	xfal
𫄈	xaik
𫄉	xkhk
𫄊	xyli
𫄋	xyff
𫄌	xkhv
𫄍	xmdo
𫄎	xnlv	xnkv
𫄏	xtdt
𫄐	xwvd
𫄑	xwpv	xwyv
𫄒	xsst
𫄓	xlfd
𫄔	xuto
𫄕	xlhi
𫄖	xdll
𫄗	xipo
𫄘	xtei
𫄙	xnn
𫄚	xgxg
𫄛	xwyn
𫄜	xtfn
𫄝	xxhh
𫄞	xgig
𫄟	xtbn
𫄠	xgjg
𫄡	xmgk
𫄢	xwdy
𫄣	xpey
𫄤	xdpy
𫄥	xgmy
𫄦	xfcl
𫄧	xthp
𫄨	xqdh
𫄩	xtxu
𫄪	xfue
𫄫	xynd
𫄬	xans
𫄭	xtjt
𫄮	xecl
𫄯	xlwt
𫄰	xupy
𫄱	xfuk
𫄲	xajd
𫄳	xthh
𫄴	xyxf
𫄵	xfke
𫄶	xxkj
𫄷	xujn
𫄸	xtgo
𫄹	xmwk
𫄺	rmkg
𫄻	rmwy
𫄼	rmas
𫄽	vhgm
𫄾	rmem
𫄿	aqkm
𫅀	lfnb
𫅁	lwxb
𫅂	ldf
𫅃	pwjj
𫅄	liqb
𫅅	lyjj
𫅆	mqqv
𫅇	lqf
𫅈	lxxw
𫅉	lsgn
𫅊	lkfk
𫅋	lwgj
𫅌	lfuf
𫅍	lued
𫅎	udbj
𫅏	uggh
𫅐	udmd
𫅑	udjg
𫅒	udna
𫅓	udud
𫅔	udve
𫅕	udda
𫅖	ugdk
𫅗	udfm
𫅘	ugak
𫅙	udmj
𫅚	ugdi
𫅛	udme
𫅜	wyck
𫅝	ugdg
𫅞	yvck
𫅟	ugdc
𫅠	ugds
𫅡	udnk
𫅢	fnf
𫅣	fqnd
𫅤	nwyc
𫅥	mnng
𫅦	ubtn
𫅧	nudh
𫅨	nlj
𫅩	ngjq
𫅪	ndjd
𫅫	rdfn
𫅬	ujng
𫅭	prgn
𫅮	nujn
𫅯	ngkp
𫅰	djdn
𫅱	thun
𫅲	ntun
𫅳	ftxx
𫅴	ftxc
𫅵	ftxt
𫅶	ftxj
𫅷	awsx
𫅸	ftxo
𫅹	dilg
𫅺	didj
𫅻	dima
𫅼	dilp
𫅽	didj
𫅾	diql
𫅿	dixm
𫆀	bbh
𫆁	bqwy
𫆂	bwgg
𫆃	nhtb
𫆄	bdgn
𫆅	bkgg
𫆆	bctd
𫆇	besy
𫆈	yntb
𫆉	tobf
𫆊	bamw
𫆋	bgkh
𫆌	buwl
𫆍	byve
𫆎	thhb
𫆏	ilrb
𫆐	bkkf
𫆑	bwgj
𫆒	bpwn
𫆓	bgke
𫆔	xfih
𫆕	dfih
𫆖	efyy
𫆗	eqbh
𫆘	eyhy	efyy
𫆙	ipef
𫆚	emg
𫆛	eway
𫆜	mwwx
𫆝	euft
𫆞	evag
𫆟	eipl
𫆠	eudj
𫆡	yceh
𫆢	fwte
𫆣	eldg
𫆤	eqg
𫆥	yneq
𫆦	eith
𫆧	etvh
𫆨	euej
𫆩	ekkp
𫆪	elwt
𫆫	mwwc
𫆬	idfe
𫆭	mwwp
𫆮	ebti
𫆯	eght	egwt	egit
𫆰	gqtw
𫆱	esrc
𫆲	eafb
𫆳	ejlc
𫆴	pnte
𫆵	egjn
𫆶	hjye
𫆷	eypx
𫆸	mwwf
𫆹	eadi
𫆺	mwwh
𫆻	exjq
𫆼	eauy
𫆽	ycex
𫆾	eafy
𫆿	leop
𫇀	edth
𫇁	etgq
𫇂	ngcq
𫇃	egmx
𫇄	ycee
𫇅	ahnr
𫇆	ahnh
𫇇	ahnt
𫇈	ahnf
𫇉	ahnm
𫇊	thpb
𫇋	thri
𫇌	thdn
𫇍	thdl
𫇎	gcfi
𫇏	gcfw
𫇐	gcfg
𫇑	gcft
𫇒	swwv
𫇓	vssg	wfsg
𫇔	tdmn
𫇕	wfkg
𫇖	tdyk
𫇗	tduo
𫇘	tdgm
𫇙	wfkl
𫇚	tetf
𫇛	tehl
𫇜	teak
𫇝	tenc
𫇞	tejc
𫇟	tedn
𫇠	teff
𫇡	teai
𫇢	teut
𫇣	teut
𫇤	fclc
𫇥	uhu
𫇦	apb
𫇧	awnb
𫇨	akj
𫇩	agf
𫇪	amqu
𫇫	awqu
𫇬	aqqu
𫇭	ayly
𫇮	aant
𫇯	akgn
𫇰	ahjf
𫇱	awbf
𫇲	awff
𫇳	awhf
𫇴	aqvf
𫇵	aveb
𫇶	agmf
𫇷	aftn
𫇸	atj
𫇹	awxw
𫇺	ayff
𫇻	aibb
𫇼	aimy
𫇽	apeu
𫇾	aiff
𫇿	agki
𫈀	akqw
𫈁	alfj
𫈂	amtu
𫈃	aqtg
𫈄	awnw
𫈅	awwk
𫈆	awlk
𫈇	arxb
𫈈	awdk
𫈉	aujf
𫈊	aiyb
𫈋	ayxx
𫈌	apfw
𫈍	anhu
𫈎	acal
𫈏	acej
𫈐	afuf
𫈑	agyu
𫈒	ageu
𫈓	agah
𫈔	ajqu
𫈕	akib
𫈖	aqju
𫈗	atkf
𫈘	awyv
𫈙	atgy
𫈚	aytu
𫈛	apmf
𫈜	aimf
𫈝	annu
𫈞	aiyx
𫈟	abai
𫈠	alkf
𫈡	agmp
𫈢	adjb
𫈣	albb
𫈤	agvi
𫈥	assk
𫈦	amwt
𫈧	ajmy
𫈨	alwj
𫈩	ajfb
𫈪	awxs
𫈫	atdw
𫈬	apwn
𫈭	aiud
𫈮	ayeu
𫈯	audy
𫈰	aiwk
𫈱	aute
𫈲	ainf
𫈳	aiii
𫈴	awga
𫈵	axqc
𫈶	agme
𫈷	asmk
𫈸	adun
𫈹	adlj
𫈺	asyw
𫈻	adfy
𫈼	aldt
𫈽	alfo
𫈾	awhh
𫈿	awnc
𫉀	arno
𫉁	aepc
𫉂	apjs
𫉃	aitj
𫉄	ayfj
𫉅	avkn
𫉆	alle
𫉇	axcb
𫉈	agkr
𫉉	aamw
𫉊	afwy
𫉋	agtj
𫉌	adfn
𫉍	aswt
𫉎	asgk
𫉏	aakc
𫉐	alpy
𫉑	aufj
𫉒	aiph
𫉓	umhi
𫉔	awnh
𫉕	awsk
𫉖	aefb
𫉗	aifu
𫉘	ayvh
𫉙	aiqo
𫉚	ayyn
𫉛	abtv
𫉜	axfm
𫉝	aggn
𫉞	akkf
𫉟	aqqu
𫉠	audb
𫉡	aeyf
𫉢	artk
𫉣	aide
𫉤	abjr
𫉥	afwl
𫉦	agqt
𫉧	ajto
𫉨	ajmc
𫉩	akwo
𫉪	atxt
𫉫	audh
𫉬	aqtc
𫉭	auss
𫉮	aujw
𫉯	aiwc
𫉰	aigl
𫉱	aoye
𫉲	apff
𫉳	ackc
𫉴	annj
𫉵	afce
𫉶	aahl
𫉷	afuf
𫉸	askw
𫉹	asrf
𫉺	aahi
𫉻	ajsb
𫉼	aldh
𫉽	awnp
𫉾	ayub
𫉿	aymi	ayli
𫊀	apwg
𫊁	ainf
𫊂	ayyf
𫊃	axmk
𫊄	axvl
𫊅	ajmi
𫊆	atdc
𫊇	adik
𫊈	awfh
𫊉	aihh
𫊊	aode
𫊋	aiws
𫊌	aglo
𫊍	aann
𫊎	awnf
𫊏	atlf
𫊐	adfq
𫊑	adtl
𫊒	aqof
𫊓	aiao
𫊔	afto
𫊕	atft	adwt	arwt
𫊖	aeyj	aeyf
𫊗	aahl
𫊘	ajah
𫊙	aqgf
𫊚	arii
𫊛	akhb
𫊜	allg
𫊝	hakd
𫊞	havd
𫊟	hatf
𫊠	hamh
𫊡	hath
𫊢	hayj	hayf
𫊣	haqo
𫊤	jxn
𫊥	jfg
𫊦	juhh
𫊧	javn
𫊨	jrnn
𫊩	jeyy
𫊪	jtay
𫊫	cuju
𫊬	jmdy
𫊭	mdju
𫊮	jhnt
𫊯	jtuh
𫊰	jqhy
𫊱	qiju
𫊲	cdju
𫊳	jgkq
𫊴	jrta
𫊵	jffy
𫊶	jiqn
𫊷	jqsy
𫊸	jtdj
𫊹	jwfc
𫊺	jxiy
𫊻	jvfy
𫊼	nju
𫊽	jkqj	jklj
𫊾	jtmt
𫊿	jwca
𫋀	jpsy
𫋁	juh
𫋂	jgvv
𫋃	jfy
𫋄	jrgb
𫋅	jrpy
𫋆	jqg
𫋇	jqys
𫋈	jyny
𫋉	yntj
𫋊	gkmj
𫋋	jgil
𫋌	jwam
𫋍	jptk
𫋎	juth
𫋏	jdfk
𫋐	jamy
𫋑	jgyg	jgqg
𫋒	dcjj
𫋓	jawk
𫋔	jyxf
𫋕	jpey
𫋖	jgkj
𫋗	jiwy
𫋘	jxlg
𫋙	jxkj	jxcj
𫋚	jfkf
𫋛	jage
𫋜	jelf
𫋝	jwys
𫋞	jwgn
𫋟	jahl
𫋠	jmau
𫋡	ynjj
𫋢	jnup
𫋣	jadj
𫋤	jfnf
𫋥	jooe
𫋦	jfhc
𫋧	jyaw
𫋨	jygi
𫋩	jhqo
𫋪	tlxx
𫋫	dwtl
𫋬	tluj
𫋭	tmdh
𫋮	tfkh
𫋯	trgh
𫋰	ttdh
𫋱	tmmh
𫋲	puaq
𫋳	puyn
𫋴	uyeu
𫋵	pujh
𫋶	puvh
𫋷	puch
𫋸	pude
𫋹	puaq
𫋺	puiq
𫋻	puwc
𫋼	puxi
𫋽	puqe
𫋾	pudn
𫋿	pust
𫌀	pugm
𫌁	pufh
𫌂	putv
𫌃	puth
𫌄	pucd
𫌅	pujr
𫌆	puvc
𫌇	pubc
𫌈	puwm
𫌉	puuo
𫌊	puaf
𫌋	puju
𫌌	pumi
𫌍	tdje
𫌎	euke
𫌏	nhde
𫌐	puft
𫌑	puuj
𫌒	puxq
𫌓	pumu
𫌔	puvd
𫌕	pudh
𫌖	pufl
𫌗	puyf
𫌘	puoc
𫌙	putj
𫌚	sty
𫌛	smth
𫌜	hqvd
𫌝	hqkq
𫌞	shqb
𫌟	gaeq
𫌠	wsgq
𫌡	fwfq
𫌢	hqff
𫌣	hqas
𫌤	fnmq
𫌥	vvhq	vhqq
𫌦	tfqq
𫌧	hqum
𫌨	qimq
𫌩	mqqk
𫌪	remq
𫌫	gliq
𫌬	sfiq
𫌭	mqtt
𫌮	qedn
𫌯	qetj
𫌰	qejr
𫌱	qenh
𫌲	yaj
𫌳	yvg
𫌴	yyy
𫌵	ccyf
𫌶	ygig
𫌷	jnyd
𫌸	wayf
𫌹	ycyg
𫌺	syf
𫌻	yyey
𫌼	ylh
𫌽	yevg
𫌾	ytxi
𫌿	ygvv
𫍀	yqg
𫍁	yakh
𫍂	yith
𫍃	ycel
𫍄	ynuh	ynuj
𫍅	ycbs
𫍆	yrvn
𫍇	ypwk
𫍈	ypqv
𫍉	yssy
𫍊	yahf
𫍋	yukg
𫍌	ycep
𫍍	yafy
𫍎	ykbt
𫍏	ynty
𫍐	hidy
𫍑	yywy
𫍒	ypxm
𫍓	yuto
𫍔	yhaa
𫍕	yntw
𫍖	ynlw
𫍗	yecu
𫍘	ynij
𫍙	ybn
𫍚	ytdy
𫍛	ywvn
𫍜	yfcy
𫍝	yanw
𫍞	ytuh
𫍟	ytbn
𫍠	yqbn
𫍡	ypxn
𫍢	yatq
𫍣	ymgk
𫍤	ytdj
𫍥	yiqn
𫍦	ypey
𫍧	ygoy
𫍨	ydfe
𫍩	ykmw
𫍪	ynny
𫍫	ydjn
𫍬	ymun
𫍭	yuvg
𫍮	ynbm
𫍯	ydgt
𫍰	ylny
𫍱	ymdj
𫍲	yvhc
𫍳	ytgf
𫍴	yovg
𫍵	ygqt
𫍶	ygct
𫍷	yrqc
𫍸	yynn
𫍹	yhag
𫍺	ytlt
𫍻	yfkk
𫍼	yujf
𫍽	ylge
𫍾	ypns
𫍿	yuen
𫎀	wwkw
𫎁	fjwk
𫎂	tvwk
𫎃	ywfu
𫎄	gkus
𫎅	egf
𫎆	ewwy
𫎇	opge
𫎈	eedy
𫎉	sfie
𫎊	eeay
𫎋	eede
𫎌	eeov
𫎍	eedn
𫎎	hmhk
𫎏	mgfh
𫎐	mtnn
𫎑	mqhh
𫎒	myn
𫎓	mpgg
𫎔	wfmu
𫎕	mymh
𫎖	mwgk
𫎗	mgik
𫎘	rrmu
𫎙	mukq
𫎚	lmqh
𫎛	qaqm
𫎜	fitm
𫎝	mxxr
𫎞	mnhh
𫎟	mftj
𫎠	ynam
𫎡	ahnm
𫎢	myin
𫎣	ycly
𫎤	wvmm
𫎥	jvdm
𫎦	mdxn
𫎧	mqkg
𫎨	mwgi
𫎩	mpws
𫎪	musy
𫎫	msjh
𫎬	ujam
𫎭	foca
𫎮	fogf
𫎯	foaj
𫎰	foxl
𫎱	fhdl
𫎲	fhfi
𫎳	fhxf
𫎴	fhmk
𫎵	fhdq
𫎶	fhai
𫎷	fhbi
𫎸	fhlr
𫎹	fhjf
𫎺	fhce
𫎻	fhjg
𫎼	fhnv
𫎽	fhfl
𫎾	fhsn
𫎿	fhdq
𫏀	khfy
𫏁	khgu
𫏂	khty
𫏃	khty
𫏄	khaf
𫏅	khmd
𫏆	khny
𫏇	khaw
𫏈	khiq
𫏉	khqk
𫏊	khwf
𫏋	khtj
𫏌	khgo
𫏍	khnt
𫏎	khvq
𫏏	khge
𫏐	lrkh
𫏑	khlq
𫏒	khwc
𫏓	khtx
𫏔	dmjh
𫏕	lcah
𫏖	khec
𫏗	khwc
𫏘	khil
𫏙	khrv
𫏚	khwk
𫏛	khyh
𫏜	khlg
𫏝	khog
𫏞	khor
𫏟	khul
𫏠	khjq
𫏡	khqe
𫏢	khte
𫏣	khgg
𫏤	khye
𫏥	khyn
𫏦	khvh
𫏧	khfj
𫏨	khqd
𫏩	khkp
𫏪	tmdj
𫏫	tmda
𫏬	tmdt
𫏭	tmdt
𫏮	tmdp
𫏯	tmdc
𫏰	tmdu
𫏱	tmdj
𫏲	lfnn
𫏳	lat
𫏴	lrg
𫏵	bilj
𫏶	ldww
𫏷	lhfg
𫏸	lqdn
𫏹	lwff	lrrh
𫏺	lefc
𫏻	ovlh
𫏼	fwfl
𫏽	ujnl
𫏾	lltk
𫏿	ltfl
𫐀	lias
𫐁	gjhl
𫐂	plvl	pkgl
𫐃	llel	lexl
𫐄	lgqn
𫐅	lmh
𫐆	ldln
𫐇	lmwy
𫐈	ldcy
𫐉	lwyc
𫐊	cdlj
𫐋	rvyl
𫐌	luah
𫐍	ltmt
𫐎	ldsk
𫐏	lmfk
𫐐	lvqn
𫐑	lpnn
𫐒	lqyg
𫐓	lcbs
𫐔	lfcl
𫐕	ldhv
𫐖	lnwe
𫐗	logy
𫐘	ldgn
𫐙	llll
𫐚	usnn
𫐛	ugmi
𫐜	ucny
𫐝	uyyw
𫐞	hpk
𫐟	api
𫐠	spi
𫐡	wynp
𫐢	dpd
𫐣	gmwp
𫐤	yspk
𫐥	ftxp
𫐦	dqpv
𫐧	rfwp
𫐨	foyp	fopi
𫐩	wwfp
𫐪	lqip
𫐫	fwqp
𫐬	atfp
𫐭	qvhp
𫐮	wgmp
𫐯	vwpi
𫐰	vqpv
𫐱	pfip
𫐲	pghp
𫐳	ehfd	fudh
𫐴	ewpi
𫐵	topi
𫐶	qkqp
𫐷	ovpd
𫐸	pahp
𫐹	nhpd
𫐺	rvnp
𫐻	qbtp
𫐼	upyp
𫐽	oitp
𫐾	egip
𫐿	gkip
𫑀	jfhp
𫑁	qtdp
𫑂	qrmp
𫑃	ynjp
𫑄	fgpd
𫑅	gkip
𫑆	fcyp
𫑇	radp
𫑈	pjmp
𫑉	ytmp
𫑊	lkmp
𫑋	gkip
𫑌	mnmp
𫑍	khgp
𫑎	tthp
𫑏	vfbp
𫑐	gkip
𫑑	mnmp
𫑒	gkip
𫑓	wnnp
𫑔	oopp
𫑕	ujfp
𫑖	djdp
𫑗	qtbh
𫑘	fnyb
𫑙	qytb
𫑚	ghnb
𫑛	anyb
𫑜	iqbh
𫑝	atdb
𫑞	egnb
𫑟	ybh
𫑠	aabh
𫑡	kjnb
𫑢	dtbh
𫑣	kgmb
𫑤	lebh
𫑥	dfeb
𫑦	jpvb
𫑧	akkb
𫑨	qobh
𫑩	ugyb
𫑪	flbh
𫑫	uqwb
𫑬	slab
𫑭	ynjb
𫑮	djfb
𫑯	yvcf
𫑰	uegb
𫑱	yvce
𫑲	elvb
𫑳	sgvy
𫑴	sgdb
𫑵	sgld
𫑶	sggu
𫑷	sgwi
𫑸	sgnn
𫑹	sgsw
𫑺	sgwh
𫑻	sgtk
𫑼	sguf
𫑽	sgni
𫑾	sgyi
𫑿	sgao
𫒀	tltn
𫒁	jfyh
𫒂	qijf
𫒃	tgjx
𫒄	ocdf
𫒅	tgjc
𫒆	qhg
𫒇	qtan
𫒈	qvf
𫒉	qbh
𫒊	qdhh
𫒋	qty
𫒌	qwjh
𫒍	qtfh
𫒎	qiy
𫒏	qlg
𫒐	qkxb
𫒑	qwfn
𫒒	qrgg
𫒓	qqhy
𫒔	qcfg
𫒕	qfff
𫒖	qsg
𫒗	qjxt
𫒘	qrmh
𫒙	qpfy
𫒚	qyoy
𫒛	qpbg
𫒜	qyfn
𫒝	qgjq
𫒞	qaah
𫒟	qwty
𫒠	qtxi
𫒡	qtnh
𫒢	qpwf
𫒣	yogq
𫒤	qybg
𫒥	qynn
𫒦	qfhg
𫒧	qfy
𫒨	qfjh
𫒩	qdwh
𫒪	qvqn
𫒫	qrqy
𫒬	qwqq
𫒭	qpgy
𫒮	qpxc
𫒯	qckq
𫒰	qfth
𫒱	qjtd
𫒲	qrdf
𫒳	qtky
𫒴	qptk
𫒵	qukc
𫒶	qbkb
𫒷	qngf
𫒸	qfkq	qfkm
𫒹	qlqn
𫒺	wnnq
𫒻	qych
𫒼	qubp
𫒽	qooq
𫒾	qxmw
𫒿	qaqh
𫓀	qafl
𫓁	qmpi
𫓂	qwga
𫓃	qphw
𫓄	qfkf
𫓅	qduh
𫓆	qfgf
𫓇	qgmi
𫓈	qgym
𫓉	qjgf
𫓊	qhgc
𫓋	qhhh
𫓌	qtwk
𫓍	qttt
𫓎	qxdx
𫓏	qdgn
𫓐	qmau
𫓑	qaqn
𫓒	qmae
𫓓	vtpq	wftq
𫓔	qugt
𫓕	qyjg
𫓖	fkuq
𫓗	qhaf
𫓘	qyww
𫓙	qxwy
𫓚	qnyf
𫓛	qddj
𫓜	qyjd
𫓝	qggq
𫓞	qssk
𫓟	qkkc
𫓠	qfnb
𫓡	qlft
𫓢	qnlw
𫓣	qjjo
𫓤	qtag
𫓥	qwy
𫓦	qbg
𫓧	qfwy
𫓨	qat
𫓩	qwwy
𫓪	qwcy
𫓫	qwgn
𫓬	qamh
𫓭	qmdy
𫓮	qqvg
𫓯	qffg
𫓰	qdgt
𫓱	qtdj
𫓲	qqjg
𫓳	qpyn
𫓴	qcrh
𫓵	qdfe
𫓶	qkeg
𫓷	qtnh
𫓸	qgot
𫓹	qadw
𫓺	qhal
𫓻	qwyn
𫓼	qtkg
𫓽	qpfi
𫓾	qyce
𫓿	qoqw
𫔀	qgli
𫔁	qfam
𫔂	qjgh
𫔃	qjtq
𫔄	qcbs
𫔅	qfpi
𫔆	qlfc
𫔇	qtlx
𫔈	qube
𫔉	qmmv
𫔊	qpwj
𫔋	qffw
𫔌	qaet
𫔍	qtol
𫔎	qcbk
𫔏	qnbb
𫔐	qfkc
𫔑	qylg
𫔒	qceo
𫔓	qfwy
𫔔	qmwk
𫔕	qodm
𫔖	dpey
𫔗	dgdn
𫔘	uhk
𫔙	auf
𫔚	ukhk
𫔛	uwxv
𫔜	udd
𫔝	uhd
𫔞	umd
𫔟	uwai
𫔠	utui
𫔡	ugku
𫔢	ukkh
𫔣	utjk
𫔤	uyfh
𫔥	uadw
𫔦	tfua
𫔧	uwww
𫔨	uwye
𫔩	uajd
𫔪	uujn
𫔫	ueed
𫔬	dnub
𫔭	ugak
𫔮	ued
𫔯	uufk
𫔰	ucak
𫔱	uyoi
𫔲	uftb
𫔳	uyfh
𫔴	uwyd
𫔵	ugct
𫔶	uths
𫔷	ugan
𫔸	jfhu
𫔹	uyml
𫔺	bdy
𫔻	byy
𫔼	bmg
𫔽	bcfg
𫔾	bbg
𫔿	bjsh
𫕀	budy
𫕁	bgkg
𫕂	bpwv
𫕃	bcbb
𫕄	bhwy
𫕅	byjg	byjf
𫕆	bgka
𫕇	bgxf
𫕈	bjqn
𫕉	befc
𫕊	bexc
𫕋	bemf
𫕌	byna
𫕍	bpgg
𫕎	bwcn
𫕏	btnf
𫕐	bdqq
𫕑	bqgl
𫕒	bumd
𫕓	bcck
𫕔	bdui
𫕕	bafk
𫕖	bskn
𫕗	byti
𫕘	bxgg
𫕙	xtvi
𫕚	wyww
𫕛	tdwy
𫕜	wngy
𫕝	fbj
𫕞	fff
𫕟	fef
𫕠	fcb
𫕡	fuxb
𫕢	fxgu
𫕣	vyfv
𫕤	fwtf
𫕥	fkmu
𫕦	fiyu
𫕧	fawv
𫕨	fcde
𫕩	fjaf
𫕪	figj
𫕫	frde
𫕬	fafl
𫕭	fihj
𫕮	fafb
𫕯	feto
𫕰	fedh
𫕱	fwys
𫕲	fwgp
𫕳	fafg
𫕴	fujn
𫕵	filf
𫕶	fnkf
𫕷	fiay
𫕸	geqh
𫕹	getg
𫕺	geuf
𫕻	gege
𫕼	geuq
𫕽	wgkd
𫕾	lfhd
𫕿	udwd
𫖀	dmjs
𫖁	dmjq
𫖂	vfbd
𫖃	dmjm
𫖄	wnhd	wwnd
𫖅	afdx
𫖆	akfw	afkw
𫖇	afwf
𫖈	nafj
𫖉	afae
𫖊	afsj
𫖋	afnc
𫖌	gkah
𫖍	nhkh
𫖎	yinh
𫖏	nhkc
𫖐	fash
𫖑	fnhn
𫖒	fnhf
𫖓	fnhf
𫖔	fnhe
𫖕	fnhf
𫖖	fnhu
𫖗	ujuf
𫖘	ujca
𫖙	ujhm
𫖚	ujpw
𫖛	ujaf
𫖜	ujte
𫖝	xxdm
𫖞	rydm
𫖟	svdm
𫖠	ehdm
𫖡	fpgm
𫖢	jfim
𫖣	hmdm
𫖤	wngm
𫖥	jgkm
𫖦	kdmk
𫖧	dmji
𫖨	ejdm
𫖩	vlqm
𫖪	tndm
𫖫	pqdm
𫖬	dmwe
𫖭	ckdm
𫖮	mndm
𫖯	iqdm
𫖰	qqdm
𫖱	vedm	vcdm
𫖲	kmdm
𫖳	vtkm
𫖴	gmdm
𫖵	rgmm
𫖶	ynem
𫖷	ansm
𫖸	drim
𫖹	dhim
𫖺	sqqm
𫖻	wcmj
𫖼	mfgs
𫖽	mftc
𫖾	wgef
𫖿	mfud
𫗀	mfiu
𫗁	mfvp
𫗂	mfvp
𫗃	mfwn
𫗄	mfwn
𫗅	thlj
𫗆	mtjn
𫗇	mqjd
𫗈	mqfb
𫗉	mqdh
𫗊	mquj
𫗋	mqgt
𫗌	dfau
𫗍	ftwe
𫗎	wpan	wyvn
𫗏	wpde	wyve
𫗐	wpwg	wyvg
𫗑	wpqc	wyvc
𫗒	wppv	wyvv
𫗓	wptk	wyvk
𫗔	wpsd	wyvd
𫗕	wpff	wyvf
𫗖	wpdd	wyvd
𫗗	wpnh	wyvh
𫗘	wptl	wyvl
𫗙	wpgm	wyvm
𫗚	ilre
𫗛	wppj	wyvj
𫗜	wpfj	wyvj
𫗝	wpal	wyvl
𫗞	qnfh
𫗟	qnfq
𫗠	qnty
𫗡	qndg
𫗢	qntf
𫗣	qnnt
𫗤	qndv
𫗥	qnpl
𫗦	qngy
𫗧	qngi
𫗨	qnye
𫗩	qnlq
𫗪	qntv
𫗫	qnde
𫗬	qndd
𫗭	qnle
𫗮	qnrg
𫗯	qnwd
𫗰	qnwp
𫗱	qnuo
𫗲	qnar
𫗳	qnxj
𫗴	qnyg
𫗵	qnye
𫗶	uthh
𫗷	uths
𫗸	uthj
𫗹	uthy
𫗺	utht
𫗻	uthe
𫗼	tjff
𫗽	tjwg
𫗾	tjfh
𫗿	tjnh	tjnj
𫘀	tjgt
𫘁	tjgm
𫘂	tjws
𫘃	tjuw
𫘄	tjpm
𫘅	ccyy
𫘆	cfwy
𫘇	caqn
𫘈	cmcy
𫘉	coy
𫘊	csg
𫘋	cgeg
𫘌	cham
𫘍	ckmk
𫘎	trtc
𫘏	cdmd
𫘐	ctgf
𫘑	cugd
𫘒	cgef
𫘓	clwt
𫘔	cwqj
𫘕	cuvo
𫘖	xqac
𫘗	casw
𫘘	khtc
𫘙	cmdo
𫘚	colw
𫘛	cfh
𫘜	cyy
𫘝	cnwy
𫘞	ctbn
𫘟	chcy
𫘠	cgcf
𫘡	ciqn
𫘢	cskg
𫘣	cjfh
𫘤	cctd
𫘥	cjxx
𫘦	cqrm
𫘧	cviy
𫘨	cjgh
𫘩	crgg
𫘪	cdri
𫘫	cjpv
𫘬	cexd
𫘭	cdqq
𫘮	cumd
𫘯	culj
𫘰	cylg
𫘱	cmwk
𫘲	mevj
𫘳	mevp
𫘴	menf
𫘵	ymkb
𫘶	rgyk
𫘷	ymkj
𫘸	denb
𫘹	deqy
𫘺	devf
𫘻	depm
𫘼	demf
𫘽	dewc
𫘾	dede
𫘿	devk
𫙀	defj
𫙁	deqq
𫙂	deov
𫙃	dejq
𫙄	gkmh
𫙅	gkme
𫙆	xwfh
𫙇	xuwh
𫙈	rqcw
𫙉	rqcq
𫙊	rqcd
𫙋	tjrc
𫙌	ffhc
𫙍	rqcl
𫙎	rqcf
𫙏	qofh
𫙐	qoaj
𫙑	qomc
𫙒	qoxh
𫙓	qdkq
𫙔	qohn
𫙕	qopw
𫙖	qonx
𫙗	qona
𫙘	qosg
𫙙	qoqc
𫙚	qoth
𫙛	qodi
𫙜	qoyv
𫙝	qoud
𫙞	qocc
𫙟	qovh
𫙠	qoey
𫙡	qorn
𫙢	qoys
𫙣	jfqo
𫙤	qosm
𫙥	qoik
𫙦	trqo
𫙧	qorp
𫙨	qowc
𫙩	qouk
𫙪	qovd
𫙫	qodn
𫙬	qoml
𫙭	qdqu
𫙮	qoqs
𫙯	qowe
𫙰	qoxl
𫙱	qofn
𫙲	qoih
𫙳	qotf
𫙴	qoyw
𫙵	qonj
𫙶	qoxl
𫙷	qokm
𫙸	qoua
𫙹	qomj
𫙺	qokt
𫙻	qopl
𫙼	qowu
𫙽	qoay
𫙾	qohe
𫙿	qoqc
𫚀	qour
𫚁	qoum
𫚂	qofy
𫚃	vqqo	wfqo
𫚄	qodl
𫚅	qovq
𫚆	qodm
𫚇	qonj
𫚈	qggg
𫚉	qgag
𫚊	qgnr
𫚋	qgfy
𫚌	qgit
𫚍	qgwv
𫚎	qggw
𫚏	qgsg
𫚐	qgmd
𫚑	qgnt
𫚒	qgxj
𫚓	gqjg
𫚔	qglk
𫚕	qgjh
𫚖	hxqg
𫚗	qgwk
𫚘	qgwf
𫚙	qggy
𫚚	qgbn
𫚛	qguq
𫚜	qgfq
𫚝	qgjs
𫚞	tqtg
𫚟	tryg
𫚠	qgub
𫚡	qgvh
𫚢	qgav
𫚣	qgwq
𫚤	qgux
𫚥	qgnc
𫚦	qgpk
𫚧	qggj
𫚨	qgub
𫚩	qgfe
𫚪	qgck
𫚫	qgks
𫚬	qgpe
𫚭	qgvn
𫚮	nwvo
𫚯	dmwo
𫚰	xxwo
𫚱	wvgc
𫚲	pmwo	pqwo
𫚳	wvgk
𫚴	twvo
𫚵	qtbo
𫚶	tuho
𫚷	mmgo
𫚸	wvge
𫚹	qbwo
𫚺	rewo
𫚻	vbwo
𫚼	wvge
𫚽	mgwo	mtfo
𫚾	kgdo
𫚿	whto
𫛀	vfbo
𫛁	gaho
𫛂	jqao
𫛃	mgyo
𫛄	hiwo
𫛅	udwo	ufho
𫛆	veho
𫛇	vcxo
𫛈	wvgy
𫛉	bbwo
𫛊	nuto
𫛋	ckno
𫛌	skso
𫛍	dwfo
𫛎	ttdo
𫛏	pwyo
𫛐	lako
𫛑	fkko
𫛒	raqo
𫛓	wvgf
𫛔	etno
𫛕	pwto
𫛖	qtco
𫛗	kako
𫛘	rrro
𫛙	pwto
𫛚	gaqg
𫛛	fcqg
𫛜	giqg
𫛝	myqg
𫛞	qynw
𫛟	dxqg
𫛠	snqg
𫛡	tpqg
𫛢	psqg
𫛣	qynw
𫛤	lkqg
𫛥	guwg
𫛦	dfng
𫛧	hiqg
𫛨	uaqg
𫛩	pvqg
𫛪	vkqg
𫛫	kmqg
𫛬	wtqg
𫛭	qtgg
𫛮	umig
𫛯	xyqg
𫛰	adwg
𫛱	hjqg
𫛲	mfkg
𫛳	ebcg
𫛴	ujfg
𫛵	nbmg
𫛶	gkig
𫛷	deqg
𫛸	jghg
𫛹	hitg
𫛺	qynd
𫛻	yacg
𫛼	wgdg
𫛽	ssqg
𫛾	qegg
𫛿	fotg
𫜀	jdfg
𫜁	umig
𫜂	ujqg
𫜃	sjqg
𫜄	usgg
𫜅	qyne
𫜆	ynwg
𫜇	hloo	hlqo
𫜈	txgo
𫜉	hloy	hlqy
𫜊	hlql
𫜋	ynjl
𫜌	ynjw
𫜍	ynjk
𫜎	ynjj
𫜏	oqax
𫜐	swwm
𫜑	gtdh
𫜒	gtpx
𫜓	gtke
𫜔	gtrf
𫜕	fpgt
𫜖	yssk
𫜗	yssj
𫜘	gmhw
𫜙	lfon
𫜚	lfon
𫜛	lfoh	lfoj
𫜜	wgni
𫜝	kkxf	kkmv
𫜞	lfox	lfov
𫜟	usgn
𫜠	hndb
𫜡	hndy
𫜢	vnug
𫜣	vnuu
𫜤	thld
𫜥	hbmm	hwwm
𫜦	hbgy	hwwy
𫜧	hbps	hwws
𫜨	hwbc
𫜩	dhvb
𫜪	hwbq
𫜫	hwby
𫜬	hwbj
𫜭	hwbr
𫜮	hwbe
𫜯	hwbk
𫜰	fmub
𫜱	amhd
𫜲	dedx
𫜳	mfqn
𫜴	ssoa
