𫠠	agn
𫠡	gwhj
𫠢	hsj
𫠣	anwi
𫠤	gqb
𫠥	gmwn
𫠦	ghth
𫠧	tfgh
𫠨	wnng
𫠩	gxxu
𫠪	nywh
𫠫	gifq
𫠬	gikh
𫠭	gigi
𫠮	gcfh
𫠯	gagh
𫠰	ghtt
𫠱	gjgh
𫠲	gima
𫠳	ghwa
𫠴	rgwc
𫠵	dhmf
𫠶	gihe
𫠷	hwdh
𫠸	hiie
𫠹	hcex
𫠺	hven
𫠻	giwy
𫠼	hrkh
𫠽	hnge
𫠾	gkhm
𫠿	hwgu
𫡀	uogj	uogf
𫡁	uvog
𫡂	uvog
𫡃	jgd	hhk	hghk
𫡄	ehj
𫡅	nhnh
𫡆	vhvd	hvvd
𫡇	wvkh
𫡈	hfuh
𫡉	pbkh
𫡊	hfuh
𫡋	fjfh
𫡌	kkhb
𫡍	tdwh
𫡎	dddh
𫡏	tte
𫡐	eqhh
𫡑	wwwi
𫡒	tmfd
𫡓	qhtu
𫡔	thgn
𫡕	tfiy
𫡖	tfnh
𫡗	dhnh
𫡘	tfnw
𫡙	tguf	tfug
𫡚	wnnf
𫡛	gxwp
𫡜	wnnt
𫡝	ejgh
𫡞	wnnn
𫡟	rlgn
𫡠	qylm
𫡡	tdke
𫡢	nfd
𫡣	nty
𫡤	vvvb
𫡥	nwgk
𫡦	wevn
𫡧	ntfc
𫡨	nfiy
𫡩	bbbb
𫡪	afsn
𫡫	nfmf
𫡬	vykw
𫡭	fjfn
𫡮	onpv
𫡯	fjen
𫡰	vdjf
𫡱	ccff
𫡲	gghy
𫡳	fjnh
𫡴	gyhg
𫡵	gfmf
𫡶	fcan
𫡷	gfgj	ghgj
𫡸	flga
𫡹	gwyg
𫡺	yfbj	yfbk
𫡻	ynke
𫡼	ylhf
𫡽	uqkk
𫡾	ynne
𫡿	ylko
𫢀	ylkj
𫢁	yjfi
𫢂	yiih
𫢃	ynky
𫢄	ynky
𫢅	wgg
𫢆	wgnn
𫢇	wjh
𫢈	wvn
𫢉	wfj
𫢊	uwhj	uiu
𫢋	wgdy
𫢌	wmyg
𫢍	rwy
𫢎	wcqn
𫢏	wxgg
𫢐	wnfh
𫢑	wdwy
𫢒	wdxn
𫢓	wkqy
𫢔	wjvg
𫢕	wwgv
𫢖	weqh
𫢗	wwet
𫢘	wcfy
𫢙	wfcl
𫢚	whge
𫢛	wthc
𫢜	wwqb
𫢝	wpgf
𫢞	wsgg
𫢟	wamy
𫢠	want
𫢡	wita
𫢢	whfg
𫢣	wwyj
𫢤	wtkq	wtjq
𫢥	wegy
𫢦	wpdc
𫢧	wykg
𫢨	wuny
𫢩	nxwn
𫢪	wlpy
𫢫	waan
𫢬	wapl
𫢭	wayy
𫢮	wawx
𫢯	waat
𫢰	wjta
𫢱	wlfn
𫢲	wjcm
𫢳	wtkq	wtlq
𫢴	wwwh
𫢵	wqah
𫢶	wyhk
𫢷	wybg
𫢸	wujf
𫢹	wpdx
𫢺	wcde
𫢻	wveh
𫢼	ckwa
𫢽	wgjt
𫢾	wsrg
𫢿	waqc
𫣀	wgih
𫣁	wkjh
𫣂	wecl
𫣃	wycv
𫣄	wdyg
𫣅	wmgu
𫣆	wldn
𫣇	wkkc
𫣈	wkkt
𫣉	wjtl
𫣊	wepc
𫣋	wrfc	wrgc
𫣌	wudc
𫣍	wybe
𫣎	wphw
𫣏	wujn
𫣐	wyke
𫣑	wlqw
𫣒	wqjn
𫣓	wtjf
𫣔	wqal
𫣕	wpgl
𫣖	wxde
𫣗	wsjh
𫣘	wgkh
𫣙	gogq
𫣚	gkqo
𫣛	wgii
𫣜	wfln
𫣝	wgmg
𫣞	whag
𫣟	waqo
𫣠	wtdj
𫣡	wpgl
𫣢	wyoj
𫣣	wdjf
𫣤	wanh
𫣥	wauh
𫣦	ways
𫣧	wlfh
𫣨	whnn
𫣩	wusr
𫣪	wynt
𫣫	wovt
𫣬	wybi
𫣭	walw
𫣮	wtmc
𫣯	wksj
𫣰	wjhc
𫣱	wynp
𫣲	wfwm
𫣳	wsse
𫣴	wahm
𫣵	wnyw
𫣶	wtfd
𫣷	wpay
𫣸	wulf
𫣹	wgkk
𫣺	wgeh
𫣻	wgkm
𫣼	wfss
𫣽	wgka
𫣾	wawo
𫣿	lmwn
𫤀	wmtm
𫤁	wimh
𫤂	wvmw	wwfw
𫤃	wnkf
𫤄	wgky
𫤅	wgki
𫤆	wgoc
𫤇	wlgp
𫤈	wwwp
𫤉	wxdk
𫤊	gkll
𫤋	ygkb
𫤌	wgot
𫤍	wgya
𫤎	wxdh
𫤏	wxdp
𫤐	wtww
𫤑	wync
𫤒	wxds
𫤓	wxdp
𫤔	wooo
𫤕	wxdi
𫤖	wmkt
𫤗	hmfq
𫤘	tlqb	tkqd
𫤙	fqpx
𫤚	iqwc
𫤛	ukqh
𫤜	kqut
𫤝	mgnq
𫤞	fquh
𫤟	kqrg
𫤠	tfqx
𫤡	iqli
𫤢	tfqg
𫤣	fffk
𫤤	iqwj
𫤥	iqjy
𫤦	iqfq
𫤧	ghsq
𫤨	iqjf
𫤩	mwvq
𫤪	wgwg
𫤫	wghn
𫤬	iwu	iqi
𫤭	tmqw
𫤮	wvhj
𫤯	cdew
𫤰	jgnw
𫤱	adwh
𫤲	wkfk
𫤳	unts	unhs
𫤴	adwj
𫤵	nhgw
𫤶	ujaw
𫤷	mumc
𫤸	pgmq
𫤹	pdfe
𫤺	pwyk
𫤻	plge
𫤼	pelf
𫤽	pujm
𫤾	unn
𫤿	ugfh
𫥀	ugmh
𫥁	urh
𫥂	ueg
𫥃	uvtt
𫥄	uhkg
𫥅	umdy
𫥆	uyni
𫥇	uyiy
𫥈	uvkg
𫥉	uxjg
𫥊	uqdb
𫥋	uvey
𫥌	ugah
𫥍	ugod
𫥎	qkqu
𫥏	usty
𫥐	ujgf
𫥑	ugkj
𫥒	uhmd
𫥓	uwgj
𫥔	uusy
𫥕	uwyf
𫥖	uwyh
𫥗	uxtw
𫥘	uwyk
𫥙	ufkf
𫥚	uhqo
𫥛	ukks
𫥜	uwyf
𫥝	uusq
𫥞	mgmh
𫥟	mgvd
𫥠	tmfo
𫥡	xrxm
𫥢	frxm
𫥣	uvom
𫥤	bmgw
𫥥	ybnu
𫥦	nsgb
𫥧	bmln
𫥨	ldbm
𫥩	ybgk
𫥪	ybjw
𫥫	ngcm
𫥬	bmaj
𫥭	iamm
𫥮	ybmw
𫥯	nygn
𫥰	vdy
𫥱	vbg
𫥲	dyvb
𫥳	dljh
𫥴	cvv
𫥵	ddnj
𫥶	guhj
𫥷	hgmj
𫥸	vhkg
𫥹	hdhj
𫥺	ogjh
𫥻	jwyc
𫥼	gogj
𫥽	tdjj
𫥾	ojh
𫥿	uqvn
𫦀	ejh
𫦁	imjh
𫦂	gjhj
𫦃	dfaj
𫦄	pegj
𫦅	vijj
𫦆	wwej
𫦇	wvin
𫦈	ywwy
𫦉	ovjh
𫦊	ujjh
𫦋	uqfv
𫦌	xqcv
𫦍	dhdv
𫦎	fpxj
𫦏	wgkj
𫦐	pwjj
𫦑	ugov
𫦒	txhj
𫦓	yttv
𫦔	nhdv
𫦕	aprj
𫦖	oguj
𫦗	qqqj
𫦘	qlwv	qlqv
𫦙	tdkj
𫦚	agkj
𫦛	hlwj
𫦜	ssyj
𫦝	tgmj
𫦞	uegj
𫦟	wwaj
𫦠	bhgj
𫦡	jjjj
𫦢	dywj
𫦣	umij
𫦤	lgf
𫦥	lkgf
𫦦	daln
𫦧	ltpy
𫦨	oln
𫦩	gmwl
𫦪	keln
𫦫	lldr
𫦬	vegl
𫦭	lyve
𫦮	adwl
𫦯	sslb
𫦰	apll
𫦱	jeln
𫦲	khln
𫦳	xqcl
𫦴	jiql
𫦵	psel
𫦶	llfx
𫦷	tuql
𫦸	oopl
𫦹	lklk
𫦺	cdwl
𫦻	llxr
𫦼	nwyl
𫦽	akgg
𫦾	vqql	wfql
𫦿	tgjl
𫧀	qfd
𫧁	qkk
𫧂	tfky
𫧃	qrwc
𫧄	qeud
𫧅	qtxi
𫧆	qyvi
𫧇	xxb
𫧈	adwx
𫧉	qkxx
𫧊	ermx
𫧋	abk
𫧌	agny
𫧍	ajd
𫧎	ahd
𫧏	awwi
𫧐	ahd
𫧑	agjg
𫧒	amkd
𫧓	agey
𫧔	yanf	ynhn
𫧕	atdq
𫧖	aamw
𫧗	awgk
𫧘	arhd
𫧙	awnf
𫧚	apdw
𫧛	abbd
𫧜	akkb
𫧝	aujm
𫧞	vcfj
𫧟	udnn
𫧠	xxfj
𫧡	ddhh
𫧢	tftf
𫧣	fmuh
𫧤	fgjf
𫧥	famy
𫧦	yxih
𫧧	lpta
𫧨	fadq
𫧩	fjjl
𫧪	tame
𫧫	fpxk
𫧬	tfyj
𫧭	fjks
𫧮	gthi
𫧯	hkmw
𫧰	hham
𫧱	hhdq
𫧲	hhpc
𫧳	hhag
𫧴	hkcc
𫧵	hhbb
𫧶	hhuq
𫧷	hlwt
𫧸	hmwu
𫧹	ghbh
𫧺	tfbh
𫧻	qtwb
𫧼	qytg
𫧽	gxxb
𫧾	qytf
𫧿	qytd
𫨀	elvb
𫨁	ynkb
𫨂	dmhk
𫨃	dfii
𫨄	dcak
𫨅	ddjd
𫨆	dguw
𫨇	dudk
𫨈	doci
𫨉	djmh
𫨊	dwwk
𫨋	dimk
𫨌	ddmi
𫨍	dlrk
𫨎	dwtt
𫨏	dujd
𫨐	dcko
𫨑	dci
𫨒	ddkc
𫨓	dkkc
𫨔	dtgf	dtff
𫨕	dtec
𫨖	dqdj
𫨗	dbbj
𫨘	dkka
𫨙	dexy
𫨚	dukb
𫨛	dxmk
𫨜	dwpw	dwyw
𫨝	dyeh
𫨞	dhlh
𫨟	dbbj
𫨠	dfyh
𫨡	dhay
𫨢	dxed
𫨣	dyjh
𫨤	dssj
𫨥	djeo
𫨦	chy
𫨧	cvng
𫨨	gjqc
𫨩	ckxx
𫨪	cvnk
𫨫	chmy
𫨬	fcsw
𫨭	fcjr
𫨮	fcwk
𫨯	fcdn
𫨰	djdc
𫨱	oguc
𫨲	gncy
𫨳	mycy
𫨴	ficy
𫨵	dnyc
𫨶	egcy
𫨷	rcy
𫨸	tdcy
𫨹	ccaq
𫨺	fncy
𫨻	nhfc
𫨼	aiic	awhc
𫨽	gjic
𫨾	dffc
𫨿	ybcy
𫩀	sfic
𫩁	qyrc	qyqc
𫩂	yjcy
𫩃	ntxc	ntwc	ntvc
𫩄	gjhc
𫩅	ccyf
𫩆	gjfc
𫩇	wybc
𫩈	flgc
𫩉	pync
𫩊	vtkc
𫩋	aumc
𫩌	kckc
𫩍	rcfl
𫩎	ywgc
𫩏	jhng
𫩐	kgnn
𫩑	dlf
𫩒	kmhh
𫩓	ktmn
𫩔	kynn
𫩕	kyt
𫩖	kun
𫩗	kcyy
𫩘	kkhh
𫩙	kknv
𫩚	kmqy
𫩛	kwwy
𫩜	krhy
𫩝	kpy
𫩞	ckng
𫩟	kagn
𫩠	ipkf
𫩡	kuxn
𫩢	kkqy
𫩣	mdkf
𫩤	kogg
𫩥	khjg
𫩦	kmgm	kmmg
𫩧	wyck
𫩨	qbkf
𫩩	kqvg
𫩪	kufg
𫩫	kddy
𫩬	dhvk
𫩭	kjh
𫩮	kjy
𫩯	kmnn
𫩰	ktuf
𫩱	ktfq
𫩲	krgk
𫩳	kwyy
𫩴	kesy
𫩵	kpyn
𫩶	pynk
𫩷	kybh
𫩸	klpy
𫩹	kxiy
𫩺	knyu
𫩻	lllk
𫩼	bbkf
𫩽	krym
𫩾	krrc
𫩿	krsy
𫪀	kfpy
𫪁	kgoy
𫪂	kgod
𫪃	kgmy
𫪄	kjcf
𫪅	kjfy
𫪆	kmgn
𫪇	kmgg
𫪈	ktxi
𫪉	kwkw	kkww
𫪊	kqkq
𫪋	trnk
𫪌	kipm
𫪍	kiny
𫪎	knnw
𫪏	kiqr
𫪐	knnk
𫪑	kbmy
𫪒	ksrc
𫪓	kdlk
𫪔	dgqx
𫪕	kgnq
𫪖	kdun
𫪗	kgah
𫪘	kaqw
𫪙	dhdk
𫪚	klrh
𫪛	kdey
𫪜	kawn
𫪝	kawv
𫪞	klkg
𫪟	kkqk
𫪠	kkpn
𫪡	kkma
𫪢	kwpv
𫪣	rgkf
𫪤	kudv
𫪥	kwqq
𫪦	ktdk
𫪧	kqys
𫪨	kqiq
𫪩	kwde
𫪪	krfm
𫪫	kwde
𫪬	kiwc
𫪭	kyqy
𫪮	ylkk
𫪯	kveh
𫪰	kvxu
𫪱	kdmv
𫪲	ksgw
𫪳	kdae
𫪴	kdiy
𫪵	kraw
𫪶	krpn
𫪷	kroy
𫪸	gklg
𫪹	gadg
𫪺	kgkh
𫪻	kmjy
𫪼	krpy
𫪽	kqqw
𫪾	kudy
𫪿	kiwh
𫫀	kukh	kusk
𫫁	knuh	knuj
𫫂	kbyw
𫫃	krcd
𫫄	krdw
𫫅	khgh
𫫆	kghh
𫫇	kgon
𫫈	hiwk
𫫉	krmw
𫫊	kwyc
𫫋	kpss
𫫌	ukvk
𫫍	kpwh
𫫎	ooqk
𫫏	kodm
𫫐	iyvk
𫫑	klyf
𫫒	kvfj
𫫓	kryk
𫫔	krfh
𫫕	ksrp
𫫖	kgkn
𫫗	kgiq
𫫘	gikk	gigk
𫫙	kxtw
𫫚	kawk
𫫛	kasg
𫫜	kqte
𫫝	ktrg
𫫞	tdwn
𫫟	ktep
𫫠	kpwj
𫫡	kydn
𫫢	kpuc
𫫣	kyxh
𫫤	kynt
𫫥	kipi
𫫦	kuqv
𫫧	kxde
𫫨	kgyg
𫫩	kgyi
𫫪	ddfk
𫫫	kdet
𫫬	kffw
𫫭	kuga
𫫮	kipr
𫫯	kqtl
𫫰	keph
𫫱	kwjy
𫫲	kqgn
𫫳	kpwb
𫫴	kxyq
𫫵	knov
𫫶	krql
𫫷	kaal
𫫸	afwk
𫫹	gdke
𫫺	kbmn
𫫻	kapg
𫫼	kldn
𫫽	hpgf
𫫾	khim
𫫿	kqwc
𫬀	ktms
𫬁	vgnk	qggk	wfgk
𫬂	kiql
𫬃	kytd
𫬄	kufe
𫬅	ynjk
𫬆	kodm
𫬇	kcqq
𫬈	krvs
𫬉	kaej
𫬊	kmnk
𫬋	kkgh
𫬌	kkpx
𫬍	kdje
𫬎	tdyc
𫬏	kyne
𫬐	kpfm
𫬑	vkeo
𫬒	krat
𫬓	krol
𫬔	fkfk	ffkk
𫬕	ksqj
𫬖	kmde
𫬗	kjnc
𫬘	klcx
𫬙	kmue
𫬚	kwvt
𫬛	kyyb
𫬜	krwc
𫬝	kfuv
𫬞	ksgg
𫬟	kfhm
𫬠	kahq
𫬡	kmad
𫬢	kkdk
𫬣	kkdt
𫬤	keam
𫬥	kqot
𫬦	kwff
𫬧	ktwh
𫬨	koom
𫬩	umwa
𫬪	ykoh
𫬫	xgrk
𫬬	kryj	kryf
𫬭	klpk
𫬮	gkdf
𫬯	nfdn	fndn
𫬰	kkpe
𫬱	kajp
𫬲	kkhk
𫬳	tyek
𫬴	vssk	wfsk
𫬵	kiyj	kiyf
𫬶	krvn
𫬷	kcdk
𫬸	fkul
𫬹	kgwy
𫬺	kaqy
𫬻	khhc
𫬼	kqej
𫬽	kkek
𫬾	kqfg
𫬿	kooo
𫭀	kahq
𫭁	kfdh
𫭂	lfk
𫭃	lpqv
𫭄	clxb
𫭅	lrci
𫭆	lfii
𫭇	ldhb
𫭈	lqjd
𫭉	lwyk
𫭊	lpdc
𫭋	lhhd
𫭌	lvwi
𫭍	ljgr
𫭎	ltky
𫭏	lujd
𫭐	lkkk
𫭑	lswt
𫭒	luim
𫭓	leee
𫭔	lgyk
𫭕	wgmm
𫭖	fnn
𫭗	fwy
𫭘	fbh
𫭙	fkg
𫭚	fiy
𫭛	fgdy
𫭜	fgkh
𫭝	ffwy
𫭞	ffny
𫭟	faqy
𫭠	hff
𫭡	fthn
𫭢	fwxn
𫭣	ruff
𫭤	fnfh
𫭥	ffiy
𫭦	fkln
𫭧	febg
𫭨	fnty
𫭩	fbff
𫭪	fatq
𫭫	faag
𫭬	hjff	hjfd
𫭭	fmag
𫭮	fmjh
𫭯	fvfy
𫭰	ffny
𫭱	fdmg
𫭲	fgod
𫭳	ffnh
𫭴	tjff
𫭵	fnnf
𫭶	uwyf
𫭷	fyg
𫭸	fybh
𫭹	vfbf
𫭺	fnfy
𫭻	fnny
𫭼	fapl
𫭽	flqy
𫭾	fqg
𫭿	wwfx
𫮀	fmfk
𫮁	fpfi
𫮂	fymg
𫮃	fujf
𫮄	bskf
𫮅	fcde
𫮆	fdty
𫮇	fdww
𫮈	fdjf
𫮉	fagh
𫮊	fefc
𫮋	qhwf
𫮌	fypm
𫮍	fukh	fusk
𫮎	fyiy	fyji
𫮏	iref
𫮐	futh
𫮑	fvfp
𫮒	fdhc
𫮓	fake	fgky
𫮔	fdwt
𫮕	fjdt
𫮖	fwvm
𫮗	feud
𫮘	fwyj
𫮙	fwee
𫮚	fpss
𫮛	fwff
𫮜	godf
𫮝	fagy
𫮞	fmjx
𫮟	wwkf
𫮠	ftel
𫮡	fioo
𫮢	fcep
𫮣	bcwf
𫮤	aihf
𫮥	fwyy
𫮦	fdjn
𫮧	fqje
𫮨	ftff
𫮩	vmff	qgmf	wfmf
𫮪	fpww
𫮫	fudi
𫮬	fxcj	fxkj
𫮭	akgk
𫮮	fajy
𫮯	wgjf
𫮰	ffwd	ffwf
𫮱	adwf
𫮲	fajf
𫮳	kckf
𫮴	foos
𫮵	fnih
𫮶	ffkk
𫮷	fjfk
𫮸	xdjf
𫮹	fadi
𫮺	pakf
𫮻	cbqf
𫮼	fnip
𫮽	fafk
𫮾	fawj
𫮿	fmdt
𫯀	jjjf
𫯁	fpgk
𫯂	fpgb
𫯃	fplh
𫯄	yyff	yfyf
𫯅	fnvx
𫯆	mgkn
𫯇	fnfp
𫯈	fpgk
𫯉	fpff	fphf
𫯊	afsl
𫯋	txgt
𫯌	yogt
𫯍	qqsh
𫯎	ttxu
𫯏	gxwh
𫯐	qqsg
𫯑	adwq
𫯒	qqpe
𫯓	swwq
𫯔	adwq
𫯕	dfeh
𫯖	qqup
𫯗	qqie
𫯘	adwq
𫯙	qquo
𫯚	qqge
𫯛	tdi
𫯜	dmhj
𫯝	hgdu
𫯞	dkhj
𫯟	duhj
𫯠	dwah
𫯡	dguh
𫯢	dant
𫯣	dfgf
𫯤	fwdg
𫯥	dmqu
𫯦	deu
𫯧	dwtf
𫯨	ntfd
𫯩	dfad
𫯪	ddww
𫯫	dgkl
𫯬	gdjx
𫯭	djgr
𫯮	dkdm
𫯯	dugn
𫯰	fwtf
𫯱	hmod
𫯲	eglw
𫯳	tgjw
𫯴	dclf
𫯵	dukb
𫯶	dith
𫯷	ubtt
𫯸	gdpn
𫯹	sgqd
𫯺	bbdu
𫯻	dmdt
𫯼	dxxi
𫯽	dskj
𫯾	ddwk
𫯿	fwua
𫰀	xlxd
𫰁	ytad
𫰂	dftf
𫰃	dwww
𫰄	exdk
𫰅	aqod
𫰆	vnn
𫰇	vcy
𫰈	vghy
𫰉	vmyy
𫰊	vvf
𫰋	vdy
𫰌	vgg
𫰍	vfnh
𫰎	vaht
𫰏	vhf
𫰐	jcvf
𫰑	vqwy
𫰒	veg
𫰓	vvfh
𫰔	vrhh
𫰕	vwen
𫰖	viy
𫰗	gmjv
𫰘	vtfj
𫰙	vwtf
𫰚	vckg
𫰛	vcag
𫰜	vddy
𫰝	vgmf
𫰞	vgqj
𫰟	vghg	vgqg
𫰠	vivg
𫰡	vwxf
𫰢	vwfc
𫰣	vpyn
𫰤	voy
𫰥	ycvf
𫰦	vpfy
𫰧	vudh
𫰨	vnud
𫰩	vbsy	vbhi	vmsy
𫰪	vftb
𫰫	vgkg
𫰬	vsag
𫰭	vfoy
𫰮	vant
𫰯	vlsy
𫰰	vwgi
𫰱	wwkv
𫰲	qkqv
𫰳	vybh
𫰴	vprh
𫰵	ntfv
𫰶	cknv
𫰷	rhcv
𫰸	vfqb
𫰹	fwmv
𫰺	vfy
𫰻	vmun
𫰼	vafc
𫰽	vwwh
𫰾	vqg
𫰿	vtoh
𫱀	vqrm
𫱁	vwyn
𫱂	vbib
𫱃	ahnv
𫱄	vdke
𫱅	vfwk
𫱆	vgkl
𫱇	vxmy
𫱈	vadc
𫱉	vuxe
𫱊	vjqn
𫱋	vrdf
𫱌	vpff
𫱍	vypm
𫱎	vudy
𫱏	ynvw
𫱐	vnah
𫱑	vdtp
𫱒	sspv
𫱓	vsgn
𫱔	vawn
𫱕	vjtl
𫱖	vkwk
𫱗	vwgr
𫱘	vexi
𫱙	vtxk
𫱚	vyxi
𫱛	vugn
𫱜	vpkk
𫱝	vuqn
𫱞	vcwy
𫱟	vfwq
𫱠	vuvg
𫱡	vanf
𫱢	vuqy
𫱣	vlag
𫱤	tgvv
𫱥	rxmv
𫱦	vqkn
𫱧	vukt
𫱨	vumk
𫱩	vcyc
𫱪	vbik
𫱫	vxlg
𫱬	vdnn
𫱭	vfyy
𫱮	vgjn
𫱯	vdjj
𫱰	vaqm
𫱱	vogi
𫱲	mgnv
𫱳	vqqu
𫱴	vhvf	qghv	wfhv
𫱵	vusf
𫱶	cbtv
𫱷	vvfj	vvhh
𫱸	vfdi
𫱹	vfie
𫱺	vfkc
𫱻	vaqt
𫱼	vhqo
𫱽	vapg
𫱾	vlkm
𫱿	hwbv
𫲀	eudv
𫲁	vpys
𫲂	vudm
𫲃	vyli
𫲄	vpwc
𫲅	gwmv
𫲆	vxth
𫲇	vapk
𫲈	vmgt
𫲉	vmdo
𫲊	vtgo
𫲋	vyne
𫲌	xgrv
𫲍	vajj
𫲎	vajn
𫲏	vajc
𫲐	vipm
𫲑	vtes
𫲒	vyjh
𫲓	ynly
𫲔	vawo
𫲕	mwnv
𫲖	mwnv
𫲗	vtfm
𫲘	vued
𫲙	vbdp
𫲚	vfkk
𫲛	vatt
𫲜	exgv
𫲝	vaal
𫲞	vjjg
𫲟	vuea
𫲠	vdkt
𫲡	bcy
𫲢	bqkg
𫲣	xvbf
𫲤	vkbg
𫲥	bjxt
𫲦	bukq
𫲧	bqg
𫲨	uvbg
𫲩	adkb
𫲪	xxmb
𫲫	wycb
𫲬	ebfj
𫲭	bujq
𫲮	bpgl
𫲯	vybf	qgyb
𫲰	vkbi
𫲱	kmab
𫲲	wnnb
𫲳	dhbd
𫲴	baui
𫲵	pff
𫲶	pvyu
𫲷	pfwu
𫲸	pdhj
𫲹	pkhj
𫲺	phf
𫲻	pqng
𫲼	peyu
𫲽	pnu
𫲾	pqkf
𫲿	puf
𫳀	pxlb
𫳁	pdmj
𫳂	pgmf
𫳃	pgog
𫳄	ppnb
𫳅	pudj
𫳆	pxxb
𫳇	pghg
𫳈	pfpq
𫳉	padu
𫳊	phff
𫳋	ptfp
𫳌	pwdk
𫳍	pisu
𫳎	piqw
𫳏	pbth
𫳐	pfuf
𫳑	pdjn
𫳒	pgji
𫳓	pkkc
𫳔	pham
𫳕	peef
𫳖	pylk
𫳗	pvlf
𫳘	pbps
𫳙	pvgy
𫳚	pgwe
𫳛	pbkf
𫳜	pdmu
𫳝	palf
𫳞	pjgr
𫳟	pmdj
𫳠	ppyf
𫳡	pnto
𫳢	pokf
𫳣	pvvv
𫳤	pgwh
𫳥	pghh
𫳦	pkeb
𫳧	pkmu
𫳨	prqb
𫳩	pttk
𫳪	prvc
𫳫	ppyd
𫳬	pngf
𫳭	pujn
𫳮	pvvc
𫳯	pdhv
𫳰	pgfy
𫳱	pakg
𫳲	pegi
𫳳	pjde
𫳴	ptot
𫳵	prhk
𫳶	pdhh
𫳷	prxc
𫳸	ptdq
𫳹	pntq
𫳺	pihc
𫳻	pnhf
𫳼	pnhg
𫳽	pggg
𫳾	pgmn
𫳿	pdhg
𫴀	plct
𫴁	pocq
𫴂	pglw
𫴃	pgml
𫴄	psft
𫴅	pggl
𫴆	pajy
𫴇	phii
𫴈	ptkc
𫴉	pedm
𫴊	pwpo
𫴋	pujh
𫴌	pugt
𫴍	posf
𫴎	pnku
𫴏	pbiq
𫴐	pfjf
𫴑	pgie
𫴒	parc
𫴓	pdhk
𫴔	pvon
𫴕	pqka
𫴖	ppyf
𫴗	ppyl
𫴘	psso
𫴙	pdhw
𫴚	pntn
𫴛	pnhv
𫴜	pgke
𫴝	pgms
𫴞	pnlb
𫴟	pyne
𫴠	peem
𫴡	pgmg
𫴢	pmdc
𫴣	piqc
𫴤	pfdv
𫴥	pxyx
𫴦	pgml
𫴧	pbef
𫴨	pglq
𫴩	ppym
𫴪	pyyy
𫴫	pgrm
𫴬	yfqh
𫴭	vfny
𫴮	jgff
𫴯	mjfy
𫴰	augf
𫴱	vftu
𫴲	vfvb
𫴳	vfga
𫴴	iamf
𫴵	vfrf
𫴶	yfkf
𫴷	vfdd
𫴸	ijg
𫴹	mwiu
𫴺	sniy
𫴻	itmw
𫴼	ufti
𫴽	ipaq
𫴾	ijxx
𫴿	rqyi
𫵀	inbm
𫵁	ipkh
𫵂	ipkh
𫵃	ivhc
𫵄	amdi
𫵅	ipke
𫵆	ithk
𫵇	nhqi
𫵈	uniy
𫵉	yvcd
𫵊	itxk
𫵋	ujni
𫵌	ipkf
𫵍	ihim
𫵎	dnui
𫵏	dnxx
𫵐	anyq
𫵑	wqhj
𫵒	wqkm
𫵓	nmwi
𫵔	ned
𫵕	nrhy
𫵖	nfii
𫵗	nyvt
𫵘	nnte
𫵙	nfhv	nfhd
𫵚	ntdf	ngak
𫵛	nyuf
𫵜	nnhc
𫵝	ncni
𫵞	ntfe
𫵟	nyra
𫵠	niah
𫵡	ntfg
𫵢	manm
𫵣	ntfy
𫵤	nqal
𫵥	nuak
𫵦	ndyu
𫵧	nyui
𫵨	nuaj
𫵩	ntgf
𫵪	nvmw	nwfw
𫵫	novx
𫵬	nevw	neww
𫵭	novk
𫵮	bfhh
𫵯	bhsn
𫵰	btnq
𫵱	mfj
𫵲	msj
𫵳	mmb
𫵴	mcy
𫵵	mnrt
𫵶	mfnh
𫵷	mdln
𫵸	mcag
𫵹	mcfu
𫵺	mqcn
𫵻	mpvf
𫵼	mgjq
𫵽	mmgj
𫵾	txgm
𫵿	mten
𫶀	mpsy
𫶁	mjqr
𫶂	mmdf
𫶃	mjnu
𫶄	myoc
𫶅	mcde
𫶆	mdgt
𫶇	mgkh
𫶈	mnua
𫶉	mngf
𫶊	mjtl
𫶋	vhpm	wfhm
𫶌	mqyl
𫶍	mpju
𫶎	mpwk
𫶏	mvtt
𫶐	mccs
𫶑	mgmu
𫶒	miss
𫶓	mpdk
𫶔	nbtm
𫶕	mapk
𫶖	bjgm
𫶗	mdwa
𫶘	mflf
𫶙	mawd
𫶚	mtfj
𫶛	mtxt
𫶜	mymh
𫶝	mdnt
𫶞	xjdm
𫶟	mdwy
𫶠	mgee
𫶡	mhim
𫶢	mhal
𫶣	mtqh
𫶤	mnbb
𫶥	maui
𫶦	mxyt
𫶧	qthn
𫶨	wtkh
𫶩	vmwc
𫶪	vyuq
𫶫	awcy
𫶬	atdu
𫶭	wtfa
𫶮	aafc
𫶯	udav
𫶰	udac
𫶱	agnj
𫶲	fnma
𫶳	alfj
𫶴	udak
𫶵	ceb
𫶶	ndqb
𫶷	kkcn
𫶸	cwgj
𫶹	xxmn
𫶺	fafb
𫶻	cahl
𫶼	cugi
𫶽	mhhy
𫶾	mhwy
𫶿	mhty
𫷀	mhtn
𫷁	wqmh
𫷂	mhnh
𫷃	gwwh
𫷄	gbgh
𫷅	mhpl
𫷆	mhmm
𫷇	tmkh
𫷈	edmh
𫷉	mhpq
𫷊	mhfw
𫷋	mhmu
𫷌	mhjl
𫷍	rmhx
𫷎	mhyk
𫷏	xqah
𫷐	mhaf
𫷑	mhil
𫷒	mhgm
𫷓	ipka
𫷔	ftnn
𫷕	fnhc
𫷖	fnfh
𫷗	rhfc
𫷘	uamn
𫷙	guhj	guhf
𫷚	guhe
𫷛	ganw
𫷜	rhff
𫷝	guhe
𫷞	rhfn
𫷟	xftn
𫷠	maxx
𫷡	xxgf
𫷢	dhxx
𫷣	xxav
𫷤	xlwp
𫷥	yvv
𫷦	yfi
𫷧	ydci
𫷨	yrii
𫷩	ynak
𫷪	ydtb
𫷫	yfti
𫷬	ygoi
𫷭	ykhi
𫷮	ybed
𫷯	yvwu
𫷰	ysrc
𫷱	ydfa
𫷲	yito
𫷳	ythp
𫷴	yoit
𫷵	yvwy
𫷶	ykfn
𫷷	yqqw
𫷸	ywye
𫷹	yovd
𫷺	ytmf
𫷻	yvww
𫷼	yfuy
𫷽	yhah
𫷾	ymmv
𫷿	ywyy
𫸀	yvhq	ynfq
𫸁	ylge
𫸂	ytek
𫸃	yfuf
𫸄	yarc
𫸅	ytto
𫸆	ywoy
𫸇	yyjd
𫸈	yoqp
𫸉	ycbp
𫸊	yamq
𫸋	yamf
𫸌	yamn
𫸍	yamj
𫸎	yame
𫸏	yamu
𫸐	yamp
𫸑	fpd
𫸒	fwfp
𫸓	atfp
𫸔	tfdp
𫸕	vfha
𫸖	vaj
𫸗	anya
𫸘	qxaj
𫸙	ngka
𫸚	dfea
𫸛	ntfa
𫸜	gjha
𫸝	djda
𫸞	qlaj
𫸟	vxaj	qgxa	wfxa
𫸠	ynja
𫸡	ntfa
𫸢	ooya
𫸣	thpa
𫸤	elva
𫸥	xdy
𫸦	xaj
𫸧	xkd
𫸨	sxjh
𫸩	xaqy
𫸪	xgna	xxn
𫸫	xdkg
𫸬	pqxh
𫸭	clxb
𫸮	xgmi
𫸯	xkdy
𫸰	xevn
𫸱	xpyn
𫸲	utxb
𫸳	xmy
𫸴	xjeg
𫸵	xthc
𫸶	xvfb
𫸷	xhga
𫸸	xjhc
𫸹	xgxf
𫸺	xxff
𫸻	xjsv
𫸼	wngu
𫸽	uxhn
𫸾	xfwl
𫸿	xujp
𫹀	xthc
𫹁	xhbh	xhwb
𫹂	xtho
𫹃	xegq
𫹄	hcvg
𫹅	vpmy
𫹆	xpgw
𫹇	xgrh
𫹈	xgoa
𫹉	sget
𫹊	rdfe
𫹋	tjh
𫹌	tvg
𫹍	tfcy
𫹎	tsy
𫹏	thcy
𫹐	toy
𫹑	tfjh
𫹒	tgkq
𫹓	tng
𫹔	thkg
𫹕	tudn
𫹖	taud
𫹗	tjyy
𫹘	ttrt
𫹙	tfku
𫹚	tfff
𫹛	tytb
𫹜	tuda
𫹝	tudc
𫹞	tcy
𫹟	tkgb
𫹠	tttd
𫹡	takg
𫹢	tynt
𫹣	tdui
𫹤	togi
𫹥	tnhy
𫹦	fhtf
𫹧	tfkm
𫹨	tuqm
𫹩	taky
𫹪	tkkt
𫹫	ngnn
𫹬	qnu
𫹭	enu
𫹮	ngng
𫹯	fnu
𫹰	nub
𫹱	vnu
𫹲	aqnu
𫹳	anu
𫹴	nfnh
𫹵	fqnu
𫹶	nitt
𫹷	nccy
𫹸	cnng
𫹹	cngn
𫹺	ndg
𫹻	finu
𫹼	naiy
𫹽	ntnr
𫹾	qnnu
𫹿	psnu
𫺀	ndnb
𫺁	guwn
𫺂	nguw
𫺃	nkgf
𫺄	janu
𫺅	wufn
𫺆	nwxf
𫺇	uwyn
𫺈	nivg
𫺉	udnu
𫺊	nyjh
𫺋	ivnu
𫺌	namy
𫺍	jvnu
𫺎	ndtb
𫺏	nrwy
𫺐	wynn
𫺑	wgyn
𫺒	nujg
𫺓	nuny
𫺔	vtkn
𫺕	vkbn
𫺖	rynn
𫺗	ahtn
𫺘	napl
𫺙	njgw	nkgw
𫺚	tecn
𫺛	wkqn
𫺜	qkqn
𫺝	nyvw
𫺞	oonu
𫺟	nxgh
𫺠	grnu
𫺡	gwyn
𫺢	nkkk
𫺣	nmdo
𫺤	nhmy
𫺥	njfj
𫺦	wvnf
𫺧	nwgk
𫺨	nrdf
𫺩	ucen
𫺪	nudj
𫺫	nudb
𫺬	nnua
𫺭	nckn
𫺮	ahnn
𫺯	awnn
𫺰	naqj
𫺱	thnb
𫺲	eqqn
𫺳	nuda
𫺴	ynne
𫺵	ugon
𫺶	nblh
𫺷	cwyn
𫺸	lqwn
𫺹	nakm
𫺺	niph
𫺻	nhve
𫺼	nehv
𫺽	thnc
𫺾	wvnk
𫺿	npwj
𫻀	npdk
𫻁	nuvq
𫻂	vcne
𫻃	ndaf
𫻄	nage
𫻅	nrmy
𫻆	qtun
𫻇	qqan
𫻈	vcnk
𫻉	vynm
𫻊	napg
𫻋	nrgh
𫻌	nuxn
𫻍	ovtn
𫻎	ujqn
𫻏	nnku
𫻐	amyh
𫻑	nakm
𫻒	lkfn
𫻓	sysn
𫻔	nmaa
𫻕	lcen
𫻖	nhae
𫻗	nuec
𫻘	nyle
𫻙	ujtn
𫻚	fpgn
𫻛	ngee
𫻜	qrno
𫻝	fkkn
𫻞	naqc
𫻟	naun
𫻠	nkee
𫻡	nyke
𫻢	fpgn
𫻣	nrqf
𫻤	nutm
𫻥	lafn
𫻦	gnat
𫻧	lat
𫻨	ady
𫻩	adhk
𫻪	ani
𫻫	afii
𫻬	lar
𫻭	fayh	fagh
𫻮	ffat
𫻯	amww
𫻰	waww
𫻱	auqi
𫻲	fiya
𫻳	adkh
𫻴	hent
𫻵	tfka
𫻶	dndt
𫻷	ftja
𫻸	adad
𫻹	imka
𫻺	hama
𫻻	vqat
𫻼	awyd
𫻽	dnnf
𫻾	avld
𫻿	afku
𫼀	hhca
𫼁	geha
𫼂	tgja
𫼃	awvo
𫼄	gmia
𫼅	fkua
𫼆	ogua
𫼇	almi
𫼈	vama
𫼉	ynat
𫼊	ynjn
𫼋	ynff
𫼌	ynaw
𫼍	yneb
𫼎	ynnf
𫼏	ynfj
𫼐	ynhw
𫼑	ynac
𫼒	ynic
𫼓	nrk
𫼔	rvn
𫼕	rtmn
𫼖	rqyy
𫼗	rcg
𫼘	rmyg
𫼙	rqan
𫼚	ruy
𫼛	rxhh
𫼜	rhkg
𫼝	rqvg
𫼞	rtuh
𫼟	rtnr
𫼠	rygg
𫼡	rxvn
𫼢	rdhg
𫼣	rxxf
𫼤	rmjh
𫼥	rmnn
𫼦	rwdc
𫼧	rwxf
𫼨	rqmy
𫼩	rumh
𫼪	rutt
𫼫	ruft
𫼬	ryoy
𫼭	rybh
𫼮	rpey
𫼯	rlpy
𫼰	rvkg
𫼱	ramy
𫼲	rgoy
𫼳	rayn
𫼴	rkkg
𫼵	rhlq
𫼶	rimy
𫼷	rkcn
𫼸	rwlh
𫼹	rwyk
𫼺	rqtg
𫼻	rwrg
𫼼	rufp
𫼽	runy
𫼾	rxey
𫼿	rnty
𫽀	rxmw
𫽁	rlpy
𫽂	rfcv
𫽃	raoy
𫽄	rbkg
𫽅	rfcy
𫽆	rawk
𫽇	rgmb	rglb
𫽈	rafw
𫽉	rhhy
𫽊	ripb
𫽋	rlqy
𫽌	rmcr
𫽍	rvcy
𫽎	rwqq
𫽏	rthf
𫽐	rqys
𫽑	mcrj
𫽒	rynf
𫽓	rynr
𫽔	ruyh
𫽕	ryoc
𫽖	rbeg
𫽗	rgil
𫽘	rgkl
𫽙	radm
𫽚	raqk
𫽛	jdhh
𫽜	rlwj
𫽝	rjcl
𫽞	rkwk
𫽟	rmck
𫽠	relg
𫽡	rwvl
𫽢	rtcg
𫽣	ruqf
𫽤	rohn
𫽥	riwh
𫽦	rivs
𫽧	rxjm
𫽨	rvtq
𫽩	rdui
𫽪	rgxf
𫽫	rgbm
𫽬	rtgr
𫽭	rkmy
𫽮	ripq
𫽯	hayr
𫽰	rwgj
𫽱	rmes
𫽲	rqye
𫽳	rttn
𫽴	rpde
𫽵	rpwn
𫽶	rciq
𫽷	ssdr
𫽸	rxtw
𫽹	rmvh
𫽺	rjlc
𫽻	rjfh
𫽼	rjfb
𫽽	riti
𫽾	rtep
𫽿	rrif
𫾀	rihv
𫾁	ruqv
𫾂	rggn
𫾃	ravj
𫾄	rjgf
𫾅	rqef
𫾆	rpjy
𫾇	rpwj
𫾈	rime
𫾉	rnpl
𫾊	rdpb
𫾋	rshn
𫾌	fvrt
𫾍	ratf
𫾎	raqy
𫾏	rtdf
𫾐	rdsh
𫾑	rtaw
𫾒	rnyf
𫾓	rfwc
𫾔	rsdp
𫾕	rajn
𫾖	rdfm
𫾗	rywa
𫾘	risj
𫾙	rtgl
𫾚	rysd
𫾛	rwgt
𫾜	rvqr	rwfr
𫾝	yssw
𫾞	rpry
𫾟	rtlf
𫾠	royo
𫾡	rtff
𫾢	raqc
𫾣	ymkc
𫾤	fffc
𫾥	fcny
𫾦	thcu
𫾧	taty
𫾨	yty
𫾩	thft
𫾪	fkty
𫾫	gkqt
𫾬	bty
𫾭	rity
𫾮	wght
𫾯	yfty
𫾰	xity
𫾱	ahkt
𫾲	gmyc
𫾳	dtft
𫾴	hqty
𫾵	wynt
𫾶	toty
𫾷	iqwt
𫾸	vkbc
𫾹	hamt
𫾺	kjvt
𫾻	jqrt
𫾼	qdet
𫾽	wgkt
𫾾	wwwt
𫾿	wync
𫿀	yity
𫿁	alty
𫿂	hpgt
𫿃	rgty
𫿄	wgkt
𫿅	qkxc
𫿆	jgty	thht	thgt
𫿇	yteg
𫿈	ahat
𫿉	ahkt
𫿊	hhhc
𫿋	that
𫿌	cext
𫿍	amwt
𫿎	dndc	dhdc
𫿏	lyet
𫿐	ntrr
𫿑	hagt
𫿒	etnt
𫿓	tolt
𫿔	qkqt
𫿕	ytaf
𫿖	xgut
𫿗	ntkc
𫿘	vety
𫿙	xxst
𫿚	nawt
𫿛	itht
𫿜	tfkt
𫿝	oylt
𫿞	godt
𫿟	rdjt
𫿠	yjft
𫿡	ynjt
𫿢	vlqt
𫿣	ssyt
𫿤	uegt
𫿥	ckot
𫿦	xgrt
𫿧	ylkt
𫿨	ytpn
𫿩	dhdt
𫿪	mmgt
𫿫	xgrt
𫿬	xgrt
𫿭	yff
𫿮	ghyy
𫿯	ymaj
𫿰	pbyy
𫿱	ssyu
𫿲	yauo
𫿳	youf
𫿴	ufeb
𫿵	wkkf
𫿶	qjqf	qqcf
𫿷	vwef
𫿸	whwf
𫿹	amhr
𫿺	cknr
𫿻	smmr
𫿼	vwsr
𫿽	fkur
𫿾	xrxr
𫿿	wqri
𬀀	ytnh
𬀁	fwyw
𬀂	yrmh
𬀃	ytat
𬀄	ytry
𬀅	ytiy
𬀆	ytxf
𬀇	ytdg
𬀈	ytkq
𬀉	yyyb
𬀊	upwy
𬀋	ytdh
𬀌	ytdq
𬀍	ytyg
𬀎	ysgn
𬀏	ytvo
𬀐	ytyt
𬀑	ytjr
𬀒	ytja
𬀓	ytpo
𬀔	ytii
𬀕	ytxt
𬀖	ytev
𬀗	yaas
𬀘	ytfg
𬀙	ytoj
𬀚	ytkf
𬀛	yyjg	yyvf
𬀜	ytty
𬀝	ytiv
𬀞	ytyj
𬀟	ytkw
𬀠	ytqe
𬀡	ytvd	ytqd	ytwd
𬀢	ytov
𬀣	ytvw	ytww
𬀤	ytqo
𬀥	aqkw
𬀦	gnjd
𬀧	jghu
𬀨	jqyy
𬀩	jfnh
𬀪	jmqn
𬀫	yjd
𬀬	jdg
𬀭	jhnr
𬀮	jcfy
𬀯	jdou
𬀰	jgqj
𬀱	jmnn
𬀲	judy
𬀳	jyou
𬀴	udjf
𬀵	jrwy
𬀶	jtgv
𬀷	tjgr
𬀸	jygq
𬀹	juxt
𬀺	njqr
𬀻	jfwf
𬀼	jgel
𬀽	jgaf
𬀾	jfjh
𬀿	jwga
𬁀	qajt
𬁁	jpeg
𬁂	gnaj
𬁃	jfdt
𬁄	jfqw
𬁅	jjag
𬁆	eftj
𬁇	jtgf
𬁈	jyvb
𬁉	nxwj
𬁊	jtwt
𬁋	jqtb
𬁌	qajn
𬁍	judc
𬁎	jpwk
𬁏	yfjr
𬁐	jewt
𬁑	jqtj
𬁒	jcbl
𬁓	jdhj
𬁔	jghf
𬁕	jffq
𬁖	jtgh
𬁗	jpgl
𬁘	jugi
𬁙	japg
𬁚	jtgw
𬁛	jyuo
𬁜	jalq
𬁝	oguj
𬁞	jawo
𬁟	jfu
𬁠	jxtr
𬁡	dcjf
𬁢	yojf
𬁣	bdhj
𬁤	vkbj
𬁥	ftga
𬁦	uqwj
𬁧	jnjw
𬁨	jeud
𬁩	ytrj
𬁪	bujf
𬁫	vfjg
𬁬	jjjb
𬁭	uljk
𬁮	uljn
𬁯	xgrj
𬁰	efh
𬁱	eftt
𬁲	etcy
𬁳	ecg
𬁴	efcy
𬁵	eaqy
𬁶	geg
𬁷	etdy
𬁸	ewbn
𬁹	bmef
𬁺	egog
𬁻	ediy
𬁼	uqwe
𬁽	ekmy
𬁾	wrce
𬁿	eudn
𬂀	eugg
𬂁	evtk
𬂂	elqy
𬂃	ywte
𬂄	uaed
𬂅	eujf
𬂆	yvch
𬂇	egyg	egqg
𬂈	dfte
𬂉	eudm
𬂊	epju
𬂋	xxje
𬂌	ecex
𬂍	ejfh
𬂎	erey
𬂏	qjee
𬂐	euqj
𬂑	deug
𬂒	ebkg
𬂓	eipe
𬂔	eope
𬂕	hero
𬂖	qjee
𬂗	errr
𬂘	btne
𬂙	ujng
𬂚	ubte
𬂛	fgh
𬂜	sgg
𬂝	sfu
𬂞	hsu
𬂟	sqtt
𬂠	sfqn
𬂡	sgg
𬂢	stmy
𬂣	swjh
𬂤	snfh
𬂥	gkia
𬂦	sbhb
𬂧	fifi
𬂨	sfqh
𬂩	sguw
𬂪	sqtb
𬂫	wnns
𬂬	swyn
𬂭	stmk
𬂮	sqsy
𬂯	stlg
𬂰	spey
𬂱	inrs
𬂲	sgkg
𬂳	saww
𬂴	sfnh
𬂵	sacy
𬂶	segl
𬂷	smhn
𬂸	stit
𬂹	srpy
𬂺	swrg
𬂻	suga
𬂼	sctd
𬂽	ssgf
𬂾	svws
𬂿	sgcl
𬃀	sfwq
𬃁	sbcy
𬃂	ssgg
𬃃	skmd
𬃄	hmws
𬃅	gkiw
𬃆	srgm
𬃇	snql
𬃈	sqqt
𬃉	swfk
𬃊	srfm
𬃋	spck
𬃌	syvl
𬃍	sirg
𬃎	syxi
𬃏	spgy
𬃐	synf
𬃑	sudq	sugq
𬃒	svws
𬃓	shck
𬃔	gmii
𬃕	sspy
𬃖	fpds
𬃗	sdjf
𬃘	safm
𬃙	sgij
𬃚	ssfc
𬃛	sadm
𬃜	sxmy
𬃝	salg
𬃞	shrh
𬃟	sagh
𬃠	swvl
𬃡	sqvn
𬃢	stef
𬃣	semf
𬃤	svhn
𬃥	thfs
𬃦	stht
𬃧	spff
𬃨	upms
𬃩	suvs
𬃪	sukh	susk
𬃫	sptq
𬃬	syjg
𬃭	spgi
𬃮	sxjm
𬃯	ansg
𬃰	sffn
𬃱	sdjg
𬃲	ssdm
𬃳	sfhl
𬃴	ssdj
𬃵	sawn
𬃶	saxi
𬃷	gkii
𬃸	sajh
𬃹	sall
𬃺	shlk
𬃻	jsgq
𬃼	sldn
𬃽	smkg
𬃾	sadt
𬃿	trfs
𬄀	sqsd
𬄁	swnh
𬄂	srgb
𬄃	stdn
𬄄	swns
𬄅	sija
𬄆	suds
𬄇	ssgo
𬄈	saya
𬄉	slqa
𬄊	sftf
𬄋	sawk
𬄌	saqe
𬄍	gkia
𬄎	smty
𬄏	stxt
𬄐	sqwy
𬄑	smrg
𬄒	stjc	stlc
𬄓	suke
𬄔	spwn
𬄕	iwys
𬄖	sphw
𬄗	sxeg
𬄘	snug
𬄙	sade
𬄚	sgfn	sghn
𬄛	sadj
𬄜	ssyk
𬄝	sadm
𬄞	fiqj
𬄟	sadd
𬄠	sadi
𬄡	saee
𬄢	shhh
𬄣	sjyi
𬄤	saaw
𬄥	skdd
𬄦	sjtq
𬄧	trhs
𬄨	sias
𬄩	bqvs
𬄪	svas
𬄫	snfj
𬄬	sfmd
𬄭	sdap
𬄮	sdng
𬄯	sadd
𬄰	sspf
𬄱	sajl
𬄲	sawd
𬄳	seel
𬄴	sqdh
𬄵	svll
𬄶	sykj
𬄷	ssfi	sfii
𬄸	sgki
𬄹	sdlm
𬄺	salq
𬄻	sayb
𬄼	skhq
𬄽	sqlm
𬄾	ooos
𬄿	sugc
𬅀	sugi
𬅁	sfkm
𬅂	sdgn
𬅃	ssxn
𬅄	fids
𬅅	saas
𬅆	sofc	sogc
𬅇	skhm
𬅈	susb
𬅉	saui
𬅊	svmw	swfw
𬅋	saur
𬅌	qjes
𬅍	srmr
𬅎	suln
𬅏	svsf
𬅐	ssxh
𬅑	sato
𬅒	smal
𬅓	gkid
𬅔	srmb
𬅕	sqsf
𬅖	sqqb
𬅗	yjfu
𬅘	svsf
𬅙	sqqb
𬅚	stud
𬅛	ssgx
𬅜	syrf
𬅝	qwaj
𬅞	gfqw
𬅟	qwnu
𬅠	vkqw
𬅡	mmgw
𬅢	guww
𬅣	teqw
𬅤	gehw
𬅥	kmww
𬅦	ebqw
𬅧	uqwh
𬅨	bhgw
𬅩	ftjw
𬅪	yvww
𬅫	famw
𬅬	ugkw
𬅭	fpfw
𬅮	jgow
𬅯	jkbw
𬅰	kkpw
𬅱	tolw
𬅲	fwkw	fqkw
𬅳	wwkn
𬅴	sqqw
𬅵	vuhw	qguw	wfuw
𬅶	mhf
𬅷	vhf
𬅸	hhf
𬅹	gmhh
𬅺	gjhf
𬅻	fchf
𬅼	gmih
𬅽	uhbh
𬅾	dfeh
𬅿	hxeg
𬆀	hhmg
𬆁	hfkq
𬆂	lrhu
𬆃	ghih
𬆄	ghpg
𬆅	imkh
𬆆	gigb
𬆇	hphd
𬆈	ghwk
𬆉	lrhu
𬆊	gkix
𬆋	hhtf	htff
𬆌	hafx
𬆍	fnmh
𬆎	hdgc
𬆏	hhkh
𬆐	lhhh
𬆑	gqan
𬆒	gqjh
𬆓	gqjj
𬆔	gqes
𬆕	gqna
𬆖	hqwf
𬆗	ckgx
𬆘	gqxv
𬆙	hqqg
𬆚	gqvi
𬆛	gqvq
𬆜	gqxf
𬆝	gqhe
𬆞	mcyn
𬆟	aqmc
𬆠	itmc
𬆡	gomc
𬆢	thfc
𬆣	wnfc	tnhc
𬆤	rimc
𬆥	gkic
𬆦	lkmc
𬆧	tfkc
𬆨	wymc
𬆩	fmuc
𬆪	tkmc
𬆫	uemc
𬆬	wgdc
𬆭	fpfc
𬆮	fpgc
𬆯	fpqc
𬆰	qftc
𬆱	qtbc
𬆲	upec
𬆳	yxtc
𬆴	dhdc
𬆵	swwc
𬆶	dtxu
𬆷	xguc
𬆸	xgui
𬆹	glwx
𬆺	qkxx
𬆻	yjfx
𬆼	tfnf
𬆽	tfnc
𬆾	tfnq
𬆿	tfnr
𬇀	tfng
𬇁	tfnn
𬇂	tfnj
𬇃	qhcn
𬇄	prgn
𬇅	tfnk
𬇆	tfnq
𬇇	cccn
𬇈	tfno
𬇉	qayv
𬇊	qaqa
𬇋	ynqa
𬇌	qask
𬇍	uqqa
𬇎	qaqk	qakk
𬇏	rnsu
𬇐	rnjn
𬇑	rnsh
𬇒	rndi
𬇓	rnfp
𬇔	iag
𬇕	idnn
𬇖	ikg
𬇗	ixn
𬇘	ifny
𬇙	imy
𬇚	ixnn
𬇛	ighg	igqg
𬇜	iduu
𬇝	igwj
𬇞	igmw
𬇟	iyiy
𬇠	idnt
𬇡	ikqn
𬇢	ikgf
𬇣	iumh
𬇤	ipbg
𬇥	iudy
𬇦	udiu
𬇧	iakh
𬇨	ifny
𬇩	isfg
𬇪	isfh
𬇫	ircn
𬇬	igod
𬇭	iith
𬇮	imcn
𬇯	iudj
𬇰	iuny
𬇱	iikg
𬇲	ivys
𬇳	inrh
𬇴	innk
𬇵	ighg
𬇶	fiyq
𬇷	isjg
𬇸	ifng
𬇹	ilgy
𬇺	imdj
𬇻	rbiu
𬇼	iqys
𬇽	iyne
𬇾	yniq
𬇿	iuxh
𬈀	iyeg
𬈁	iujf
𬈂	iblg
𬈃	icuh
𬈄	xwei
𬈅	ifch
𬈆	igkl
𬈇	igms
𬈈	ifjh
𬈉	ifrk
𬈊	iaqk
𬈋	ijcl
𬈌	ijqk
𬈍	ivhn
𬈎	ituf
𬈏	itcg
𬈐	ipwh
𬈑	ipew
𬈒	iprx
𬈓	ipqx
𬈔	iilg
𬈕	ixjm
𬈖	igxb
𬈗	irev
𬈘	iawi
𬈙	idwi
𬈚	igeb
𬈛	idri
𬈜	iapi
𬈝	iwgk
𬈞	itfn
𬈟	iuye
𬈠	iylg
𬈡	pfji
𬈢	iuqb
𬈣	iukq
𬈤	inxg
𬈥	isse
𬈦	idmj
𬈧	ifuk
𬈨	ilub
𬈩	iagy
𬈪	iljh
𬈫	itjf
𬈬	ievn
𬈭	itgl
𬈮	iyyf
𬈯	ipwk
𬈰	iych
𬈱	ihcm
𬈲	igaw
𬈳	ifyy
𬈴	igeh
𬈵	iaqo
𬈶	ihxi
𬈷	iips
𬈸	iauk
𬈹	itdq
𬈺	idjn
𬈻	itdr
𬈼	iwpy
𬈽	iebh
𬈾	itdm
𬈿	ipds
𬉀	iydk
𬉁	iyoj
𬉂	ioaw
𬉃	iuhn
𬉄	ipgl
𬉅	uhwi
𬉆	inov
𬉇	ingw
𬉈	ifyh
𬉉	iaal
𬉊	ibkg
𬉋	ikhp
𬉌	ikfw
𬉍	imdy
𬉎	ietf
𬉏	itmm
𬉐	imcm
𬉑	iynf
𬉒	iorg
𬉓	ifwm
𬉔	iadt
𬉕	itxq
𬉖	qkxi
𬉗	ipnj
𬉘	iupt
𬉙	iual
𬉚	inxg
𬉛	ilay
𬉜	ihae
𬉝	iexh
𬉞	iiay
𬉟	sami
𬉠	iaui
𬉡	iann
𬉢	ikka
𬉣	iwpt	iwyt
𬉤	itcy
𬉥	ifjn
𬉦	ifjj
𬉧	ifjh
𬉨	jgji
𬉩	iynf
𬉪	ixuf
𬉫	iycf
𬉬	ipwn
𬉭	inky
𬉮	ifcl
𬉯	txgi
𬉰	iaae
𬉱	qkxi
𬉲	ixyq
𬉳	ixyo
𬉴	ofy
𬉵	dou
𬉶	gfou
𬉷	ohg
𬉸	okf
𬉹	qou
𬉺	onn
𬉻	ghno
𬉼	oaqy
𬉽	omnn
𬉾	omyg
𬉿	eou
𬊀	oyn
𬊁	omfg
𬊂	oqvg
𬊃	ogmi
𬊄	omgh
𬊅	oeny
𬊆	oeny
𬊇	ooqu
𬊈	ovfy
𬊉	odpy
𬊊	ogah
𬊋	ofiy
𬊌	ofny
𬊍	odtf
𬊎	oamy
𬊏	jqyo
𬊐	hndo
𬊑	okkh
𬊒	okgg
𬊓	enno
𬊔	oten
𬊕	oqkq
𬊖	ouyy
𬊗	olrh
𬊘	jjou
𬊙	jqro
𬊚	jeou
𬊛	jqro
𬊜	olqy
𬊝	oqg
𬊞	woou
𬊟	qjqo
𬊠	owtm
𬊡	oqrn
𬊢	ouyh
𬊣	oyiy
𬊤	oujf
𬊥	oylk
𬊦	oomq
𬊧	yiou
𬊨	ovcx
𬊩	oseg
𬊪	dmou
𬊫	kelo
𬊬	ohko
𬊭	ojog
𬊮	orfh
𬊯	otcg
𬊰	oute
𬊱	ouph
𬊲	dhko
𬊳	oajh
𬊴	olux
𬊵	oipq
𬊶	ojtl
𬊷	ownc
𬊸	orug
𬊹	qvro
𬊺	oepc
𬊻	rrou
𬊼	ouce
𬊽	vofn
𬊾	cwyo
𬊿	olpy
𬋀	bano
𬋁	ohqs
𬋂	otjf
𬋃	owgt
𬋄	oxxg
𬋅	ogjn
𬋆	oglh
𬋇	bbou
𬋈	swyo
𬋉	oogi
𬋊	oeph
𬋋	opgl
𬋌	ouge
𬋍	ogkm
𬋎	apgo
𬋏	ojqw
𬋐	tfvo
𬋑	mmou
𬋒	wtgo
𬋓	qvoo
𬋔	osse
𬋕	sgwo
𬋖	afuo
𬋗	oqnh
𬋘	qodi
𬋙	ovmw	owfw
𬋚	oqnn
𬋛	otqh
𬋜	oyky
𬋝	xgro
𬋞	ogmx
𬋟	ojpe
𬋠	yyyo
𬋡	vqqo	wfqo
𬋢	tqmo	tqxo	ttmo	ttxo
𬋣	fkko
𬋤	rhym
𬋥	evcu
𬋦	rhyw
𬋧	eyeu
𬋨	qvhs
𬋩	epnn
𬋪	epfc	epgc
𬋫	efth
𬋬	rhyk
𬋭	erhf
𬋮	epch
𬋯	eaoc
𬋰	ttfy
𬋱	etnh
𬋲	ebnw
𬋳	rhyc
𬋴	epqa
𬋵	ehau
𬋶	ecmg
𬋷	elyf
𬋸	excu
𬋹	ecmk
𬋺	elvr
𬋻	wqdu
𬋼	wqui
𬋽	ynjq
𬋾	ogwc
𬋿	nhdq
𬌀	nhdf
𬌁	nhdu
𬌂	nhdf
𬌃	nhdi
𬌄	nhdd
𬌅	nhdl
𬌆	nhdj
𬌇	nhdn
𬌈	nhdh
𬌉	nhdc
𬌊	nhdk
𬌋	nhdw
𬌌	nhdl
𬌍	nhde
𬌎	nhdw
𬌏	nhdm
𬌐	nhdw
𬌑	nhda
𬌒	uqfg
𬌓	thgn
𬌔	thgn
𬌕	thgg
𬌖	axrn
𬌗	ahtk
𬌘	ahtt
𬌙	trwy
𬌚	trdy
𬌛	jcrh
𬌜	trit
𬌝	trqv
𬌞	trkk
𬌟	uprh
𬌠	trjf
𬌡	trjs
𬌢	ebnh
𬌣	trfh
𬌤	trjr
𬌥	trov
𬌦	trjf
𬌧	trmj
𬌨	trqo
𬌩	qtyi
𬌪	daj
𬌫	qttc
𬌬	qtda
𬌭	qtna
𬌮	qtaq
𬌯	qtbg
𬌰	drey
𬌱	qtut
𬌲	qtsg
𬌳	gafd
𬌴	qtvo
𬌵	qtlp
𬌶	qtag
𬌷	qtce
𬌸	qtdj
𬌹	qtff
𬌺	qtjr
𬌻	qtqm
𬌼	qtvl
𬌽	qtdf
𬌾	qmwd
𬌿	qtuy
𬍀	qtye
𬍁	qtlp
𬍂	qttg
𬍃	qtuh
𬍄	qtys
𬍅	qtpw
𬍆	qtfy
𬍇	qtro
𬍈	gmwd
𬍉	qtqt
𬍊	vydy
𬍋	vgnd	wfgd
𬍌	qtqd
𬍍	qtff
𬍎	qtfe
𬍏	yxih
𬍐	gfhh
𬍑	gmh
𬍒	gfcy
𬍓	gsy
𬍔	gavn
𬍕	gwxn
𬍖	giy
𬍗	gart
𬍘	gdkg
𬍙	gdnt
𬍚	gthf
𬍛	gqiy
𬍜	gpsh
𬍝	gxcy
𬍞	gtgy
𬍟	wggy
𬍠	gyey
𬍡	inry
𬍢	udgy
𬍣	gvkg
𬍤	gvfy
𬍥	ggey
𬍦	gwwc
𬍧	guh
𬍨	gvkb
𬍩	gcnh
𬍪	gbkg
𬍫	ggvh
𬍬	gfuf
𬍭	gdlk
𬍮	gmwe
𬍯	gjsy
𬍰	gmdg
𬍱	gwgb
𬍲	gtgg
𬍳	gybg
𬍴	gdwd
𬍵	gdmd
𬍶	gjug
𬍷	gagh
𬍸	grfh
𬍹	gqkx
𬍺	gcel
𬍻	glpy
𬍼	gygy
𬍽	gkmy
𬍾	grnt
𬍿	gtgy
𬎀	grvc
𬎁	gynn
𬎂	gpwy
𬎃	guwl
𬎄	gbti
𬎅	gfvg
𬎆	gapy
𬎇	gajd
𬎈	gapb
𬎉	gwnh
𬎊	gyye
𬎋	gggn
𬎌	gffc
𬎍	gfup
𬎎	gjgf
𬎏	ghxi
𬎐	gtwk
𬎑	gugi
𬎒	gpty
𬎓	gfwk
𬎔	gafr
𬎕	fity
𬎖	gusr
𬎗	gmuj
𬎘	gqlm
𬎙	gtqn
𬎚	gsdp
𬎛	ggeh
𬎜	glke
𬎝	gehc
𬎞	gpgm
𬎟	gaui
𬎠	gnij
𬎡	gtud
𬎢	rcyq
𬎣	rcyp
𬎤	gnyc
𬎥	agnn
𬎦	gnyy
𬎧	wwgn
𬎨	esgn
𬎩	rhgn
𬎪	wgkn
𬎫	ubtn
𬎬	jfcn
𬎭	gnyj
𬎮	gnyf
𬎯	gnyk
𬎰	gnyw
𬎱	afes
𬎲	adwg
𬎳	tgsy
𬎴	tgwk
𬎵	tgut
𬎶	tgvo
𬎷	lfng
𬎸	vqtg
𬎹	tgmk
𬎺	tgri
𬎻	utth
𬎼	uetg
𬎽	eqhh
𬎾	vehk
𬎿	ulf
𬏀	lqyy
𬏁	meyu
𬏂	lqiy
𬏃	ltuh
𬏄	gajl
𬏅	tlkq
𬏆	dhcl
𬏇	lgah
𬏈	llsj
𬏉	lpfq
𬏊	lyve
𬏋	laeu
𬏌	mfhn
𬏍	jhjh
𬏎	tolf
𬏏	exil
𬏐	lymk
𬏑	lujn
𬏒	lvye
𬏓	tolc
𬏔	tolv
𬏕	mkkf
𬏖	lawa
𬏗	tolw
𬏘	lawn
𬏙	oonh
𬏚	ugd
𬏛	ufte
𬏜	ucd
𬏝	uhbk
𬏞	uyne
𬏟	uyfk
𬏠	uxnv
𬏡	udnt
𬏢	udad
𬏣	uwmk
𬏤	uqii
𬏥	uqgb
𬏦	unty
𬏧	urvy
𬏨	ukta
𬏩	uitl
𬏪	upvd
𬏫	uplk
𬏬	und
𬏭	ufoi
𬏮	ukmw
𬏯	ueee
𬏰	uegy
𬏱	uimc
𬏲	umum
𬏳	umfk
𬏴	uncf
𬏵	unfd
𬏶	udmd
𬏷	ufam
𬏸	upff
𬏹	uvmh	uqgh	uwfh
𬏺	ulei
𬏻	uqmt
𬏼	ulfo
𬏽	ulmi
𬏾	ujel
𬏿	ussd
𬐀	unkf
𬐁	uugi
𬐂	wfhf	wfnf
𬐃	rgf
𬐄	rqug
𬐅	ryu
𬐆	rtpu
𬐇	rtdu
𬐈	rftn
𬐉	ivrg
𬐊	tfkr
𬐋	dcrg
𬐌	rrhc
𬐍	rgfq
𬐎	rywf
𬐏	eqkr
𬐐	rpfe
𬐑	rgmo
𬐒	chci
𬐓	iphc
𬐔	ynic
𬐕	hceb
𬐖	hcnf
𬐗	wnlf
𬐘	nlf
𬐙	lnfh
𬐚	tklf
𬐛	imlf
𬐜	aflf
𬐝	aalf
𬐞	pgfl
𬐟	gflc
𬐠	snrl
𬐡	trnl
𬐢	gvhl
𬐣	dskl
𬐤	djdl
𬐥	ipxl
𬐦	itlf
𬐧	lnjw
𬐨	dgkl
𬐩	gilk
𬐪	wynl
𬐫	tebl
𬐬	tfvl
𬐭	uwlh
𬐮	iudl
𬐯	itel
𬐰	ytel
𬐱	ahnl
𬐲	khgl
𬐳	rlgl
𬐴	idgl
𬐵	oexl
𬐶	sgtl
𬐷	yxtl
𬐸	halh
𬐹	qrml
𬐺	omwl
𬐻	ihll
𬐼	iqwl
𬐽	ynjl
𬐾	adwl
𬐿	jvdl
𬑀	kkdl
𬑁	hagl
𬑂	xokl
𬑃	qdul
𬑄	qkhl
𬑅	hqhh
𬑆	hwxn
𬑇	htay
𬑈	hguh
𬑉	gshg
𬑊	hsgg
𬑋	hlwy
𬑌	hwfn
𬑍	hqvg
𬑎	hbmh
𬑏	hcag
𬑐	hdeg
𬑑	hftx
𬑒	hatq
𬑓	hwxf
𬑔	leu
𬑕	hplh
𬑖	hgae
𬑗	hujg
𬑘	hgah
𬑙	hfnd
𬑚	fhah
𬑛	hwyn
𬑜	huxe
𬑝	hckh
𬑞	hgqt
𬑟	hehd
𬑠	hwyc
𬑡	hqbt
𬑢	hyop
𬑣	hymk
𬑤	ajdh
𬑥	hiwy
𬑦	hvcq
𬑧	hxrh
𬑨	hgwd
𬑩	htgf
𬑪	hhwd
𬑫	hgsf
𬑬	hvqq	hwfq
𬑭	cbtm
𬑮	cbtf
𬑯	cbts
𬑰	tduf
𬑱	tdps
𬑲	tdtu
𬑳	tdut
𬑴	tdsw
𬑵	udtu
𬑶	tdge
𬑷	tdyh
𬑸	tdgd
𬑹	ddt
𬑺	dfy
𬑻	dtfh
𬑼	dtcy
𬑽	fjdd
𬑾	dgdy
𬑿	dty
𬒀	dqan
𬒁	dtdy
𬒂	dyn
𬒃	danw
𬒄	dlnn
𬒅	dmnn
𬒆	dogg
𬒇	dufg
𬒈	ipdf
𬒉	ddqb
𬒊	dwfc
𬒋	dmsy
𬒌	dudj
𬒍	dkmy
𬒎	djcf
𬒏	dmcn
𬒐	dtxu
𬒑	dpfq
𬒒	dlnn
𬒓	dlqy
𬒔	dheg
𬒕	dvij
𬒖	dgkl
𬒗	djtq
𬒘	dwyg
𬒙	dugd
𬒚	dplh
𬒛	danh
𬒜	dhbq
𬒝	dtfp
𬒞	dpgw
𬒟	sgqd
𬒠	dggn
𬒡	ddwy
𬒢	dagf
𬒣	djju
𬒤	dhnn
𬒥	dlge
𬒦	dapk
𬒧	dhca
𬒨	ddec
𬒩	dgjy
𬒪	dhay
𬒫	dtww
𬒬	pyag
𬒭	pygh
𬒮	pynw
𬒯	pynh
𬒰	pynf
𬒱	pylh
𬒲	pytc
𬒳	pyhc
𬒴	pyrm
𬒵	yofi
𬒶	pygi
𬒷	pygk
𬒸	pynw
𬒹	pymy
𬒺	pykh
𬒻	pymn
𬒼	pynq
𬒽	pyvk
𬒾	pyge
𬒿	pymw
𬓀	pymf
𬓁	pyjr
𬓂	ipki
𬓃	pyee
𬓄	pyqh	pyeh
𬓅	pypb
𬓆	pyph
𬓇	pypg
𬓈	pyvi
𬓉	pydj
𬓊	gkii
𬓋	pyqd
𬓌	pyyb
𬓍	pyyd
𬓎	pygj
𬓏	pywc
𬓐	pynn
𬓑	pyag
𬓒	pyff
𬓓	pyne
𬓔	pytn
𬓕	pyue
𬓖	pyyi
𬓗	pyvh
𬓘	sfie
𬓙	pyjc
𬓚	pytk
𬓛	pysi
𬓜	sfij
𬓝	pynw
𬓞	ybmc
𬓟	ybmq
𬓠	tmn
𬓡	twwi
𬓢	twyn
𬓣	tnfh
𬓤	tnyy
𬓥	tdfh
𬓦	tycq
𬓧	wtft
𬓨	tunn
𬓩	tvqy
𬓪	tjwe
𬓫	tqjn
𬓬	ttrt
𬓭	tgwf
𬓮	timk
𬓯	tuql
𬓰	tywy
𬓱	tfam
𬓲	thmy
𬓳	tlwj
𬓴	teeh
𬓵	twcn
𬓶	ttaf
𬓷	ttlf
𬓸	twir
𬓹	tnie
𬓺	fwft
𬓻	tdnu
𬓼	tmkm
𬓽	trde
𬓾	tjgf
𬓿	tkkf
𬔀	twyp
𬔁	tajl
𬔂	tyik
𬔃	tflm
𬔄	tagn
𬔅	pwnh
𬔆	pwtn
𬔇	pwou
𬔈	pwmg
𬔉	pwkk
𬔊	pwch
𬔋	pwdh
𬔌	pwaf
𬔍	pwma
𬔎	pwwk
𬔏	pwtd
𬔐	pwag
𬔑	pwhh
𬔒	pwis
𬔓	pwok
𬔔	pwan
𬔕	pwaq
𬔖	unb
𬔗	ghug
𬔘	urh
𬔙	vfug
𬔚	uvwy
𬔛	anuf
𬔜	uhcy
𬔝	ubhn
𬔞	uevg
𬔟	cknu
𬔠	ckug
𬔡	udey
𬔢	ipku
𬔣	uwgb
𬔤	uleg
𬔥	utgf
𬔦	uiry
𬔧	ujnh
𬔨	uguo	uguw
𬔩	uhuw
𬔪	uwfm
𬔫	uslm
𬔬	teb
𬔭	tlf
𬔮	tfwu
𬔯	taqu
𬔰	tnu
𬔱	tpu
𬔲	tou
𬔳	tguh
𬔴	tfiu
𬔵	tgyu
𬔶	tuxb
𬔷	tqhu
𬔸	tbmb
𬔹	tnty
𬔺	tfdu
𬔻	twyu
𬔼	twtu
𬔽	tqkf
𬔾	treu
𬔿	tigf
𬕀	tpfu
𬕁	tyeu
𬕂	tamu
𬕃	tgik
𬕄	tgmy
𬕅	twuf
𬕆	ttrt
𬕇	tqhf
𬕈	twgh
𬕉	tmmc
𬕊	tunu
𬕋	tiqc
𬕌	tysu
𬕍	tiit
𬕎	tgfq
𬕏	tdwh
𬕐	tjqu
𬕑	tjjf
𬕒	timk
𬕓	ttdt
𬕔	teef
𬕕	tthr
𬕖	tpgh
𬕗	tyrj
𬕘	tigh
𬕙	tisg
𬕚	tdgt
𬕛	tldf
𬕜	tmtj
𬕝	tjgf	tthh
𬕞	tyeu
𬕟	tymp
𬕠	tigg
𬕡	txaf
𬕢	tsgn
𬕣	tsgh
𬕤	tsve
𬕥	twtv
𬕦	tpuq
𬕧	titu
𬕨	tyve
𬕩	trhj
𬕪	tkkt
𬕫	tmtl
𬕬	twym
𬕭	tsdt
𬕮	tsqf
𬕯	trec
𬕰	ttfk
𬕱	tygh
𬕲	tpdj
𬕳	tcqh
𬕴	tbmn
𬕵	tadg
𬕶	tlfe
𬕷	twgn
𬕸	tqaf
𬕹	tujh
𬕺	tujh
𬕻	tbln
𬕼	ttdn
𬕽	tdiy
𬕾	tujh
𬕿	todm
𬖀	tkhh
𬖁	tdii
𬖂	ttfj
𬖃	ttfm
𬖄	tuto
𬖅	tujn
𬖆	tuja
𬖇	thhy
𬖈	tlwy
𬖉	tujg
𬖊	tycy
𬖋	onn
𬖌	owy
𬖍	owy
𬖎	ocy
𬖏	okg
𬖐	ofwy
𬖑	omqn
𬖒	owxn
𬖓	osgg
𬖔	osyy
𬖕	oqry
𬖖	oqvg
𬖗	ovcy
𬖘	ocfh
𬖙	orgk
𬖚	ovsy
𬖛	oyoy
𬖜	onwc
𬖝	ojfh
𬖞	ojfy
𬖟	ouny
𬖠	ovuf
𬖡	oftj
𬖢	oldg
𬖣	opgh
𬖤	occc
𬖥	ovph
𬖦	odjb
𬖧	okjh
𬖨	oqak
𬖩	oqah
𬖪	onua
𬖫	somc
𬖬	omic
𬖭	ohkg
𬖮	ojtl
𬖯	temo
𬖰	oymk
𬖱	oudf
𬖲	obtj	obhj
𬖳	wync
𬖴	owfi
𬖵	opnm
𬖶	oaqo
𬖷	ohkj
𬖸	otwk
𬖹	otie
𬖺	ougi
𬖻	jwgo
𬖼	oegb
𬖽	oiay
𬖾	ohcm
𬖿	oqak
𬗀	ohkm
𬗁	some
𬗂	obbb
𬗃	xfhh
𬗄	xmyy
𬗅	xecy
𬗆	xbnn
𬗇	xdnt
𬗈	xgyy
𬗉	xqgb
𬗊	xyni
𬗋	hxiy
𬗌	xjy
𬗍	ktai
𬗎	kxiy
𬗏	xkmh
𬗐	ycpi
𬗑	xyey
𬗒	xpgf
𬗓	xumh
𬗔	xyfy
𬗕	xaah
𬗖	xgku
𬗗	xrrh
𬗘	xgmu
𬗙	xknd	xkgd
𬗚	xqlg
𬗛	xtaf
𬗜	xtgh	xtgf
𬗝	xceh
𬗞	xvkb
𬗟	xdlk
𬗠	xgey
𬗡	xjjg
𬗢	xlfn
𬗣	xqrr
𬗤	xqde
𬗥	xnjg
𬗦	xpeg
𬗧	xgri
𬗨	xxmy
𬗩	xdrh
𬗪	gxic
𬗫	hnii	hixi
𬗬	xrgg
𬗭	xuxx
𬗮	xugd
𬗯	xamy
𬗰	xgqi
𬗱	xlgs
𬗲	xwhe
𬗳	xgkt
𬗴	xswt
𬗵	xfuy
𬗶	mkxi
𬗷	xtvh
𬗸	xqki
𬗹	xese
𬗺	xtmg
𬗻	xajl
𬗼	xsso
𬗽	xlsf
𬗾	gxic
𬗿	xwyc
𬘀	xiva
𬘁	xxxt
𬘂	xcbm
𬘃	xgfx	xghx	xgfi	xghi
𬘄	xgjx	xgji
𬘅	xlud
𬘆	xjdh	xbfh	xemh
𬘇	xqlq
𬘈	xtqh
𬘉	xdlf
𬘊	xlcx
𬘋	xrrm
𬘌	xooy
𬘍	xlkx	xlki
𬘎	xavj	xavh
𬘏	xofq
𬘐	xfnc
𬘑	xogl
𬘒	xuuw
𬘓	xkh
𬘔	xghn
𬘕	xdnn
𬘖	xmqn
𬘗	xqcy
𬘘	xpqn
𬘙	xant
𬘚	xgsy
𬘛	xfcy
𬘜	xjgg
𬘝	xwet
𬘞	xqyg
𬘟	xsg
𬘠	xdeg
𬘡	xldy
𬘢	xiqn
𬘣	xkmh
𬘤	xkkg
𬘥	xwgg
𬘦	xrey
𬘧	xyjh
𬘨	xfny
𬘩	xtfp
𬘪	xwgi
𬘫	xpfq
𬘬	xgeg
𬘭	xssy
𬘮	xemq
𬘯	xybg
𬘰	xdmd
𬘱	xsvg
𬘲	xdqq
𬘳	xedm
𬘴	xtoy
𬘵	xngg
𬘶	xusg
𬘷	xuda
𬘸	xnxs
𬘹	xfal
𬘺	xevg
𬘻	xpdk
𬘼	xbmi
𬘽	xnuh
𬘾	xdqq
𬘿	xgmj
𬙀	xtmg
𬙁	xuqv
𬙂	xpgw
𬙃	xfwn
𬙄	xfhk
𬙅	xafj
𬙆	xtol
𬙇	xqdo
𬙈	xoqh
𬙉	xylg
𬙊	xlff
𬙋	xyke
𬙌	rmxx
𬙍	rmfj
𬙎	rmhn
𬙏	rmiv
𬙐	rmvi
𬙑	rman
𬙒	rmle
𬙓	rmhh
𬙔	rmil
𬙕	lhgf
𬙖	lghu
𬙗	pwgf
𬙘	lgfj
𬙙	lyb
𬙚	lanb
𬙛	lduu
𬙜	ltdu
𬙝	lxxf
𬙞	lfca
𬙟	latd
𬙠	lxxd
𬙡	mqqw
𬙢	ljqr
𬙣	lyna
𬙤	lrgy
𬙥	ltmf
𬙦	liec
𬙧	lqje
𬙨	lntc
𬙩	lulu
𬙪	lxle
𬙫	lxle
𬙬	ugaj
𬙭	udfh
𬙮	ugrh
𬙯	udpg
𬙰	ugxu
𬙱	uddt
𬙲	udga	udff	udgf
𬙳	udka	ugka
𬙴	ugdn
𬙵	ugdw
𬙶	udee	ugee
𬙷	uxed
𬙸	yjfd
𬙹	fvtd
𬙺	ugda
𬙻	udul
𬙼	ugdf
𬙽	uduc
𬙾	ugds
𬙿	udue
𬚀	vtkd
𬚁	uduv
𬚂	udna
𬚃	nkhu
𬚄	vijn
𬚅	nwld
𬚆	ncex
𬚇	ynnw
𬚈	npgw
𬚉	ftvb
𬚊	ftxb
𬚋	ftdf
𬚌	adwx
𬚍	ftjj
𬚎	xglx
𬚏	dmjc
𬚐	diqc
𬚑	diay
𬚒	bfnn
𬚓	bdy
𬚔	bwfn
𬚕	bebg
𬚖	bvkg
𬚗	bdfn
𬚘	bgcf
𬚙	bidy
𬚚	btrt
𬚛	budy
𬚜	bukq
𬚝	byg
𬚞	skbb
𬚟	bwyg
𬚠	btlq	btkq
𬚡	bamd
𬚢	vcab
𬚣	bhwb
𬚤	bwyk
𬚥	budp
𬚦	bagf
𬚧	bybt
𬚨	bgwq
𬚩	mmmb	mdmb	mddb
𬚪	vfqu
𬚫	ynkh
𬚬	tfqe
𬚭	wngh
𬚮	qgqh
𬚯	efg
𬚰	mqef
𬚱	mwwn
𬚲	mwwn
𬚳	ned
𬚴	mwwh
𬚵	ewfn
𬚶	mwwg
𬚷	emgd
𬚸	tdmw
𬚹	eesy
𬚺	mwww
𬚻	egdk
𬚼	egah
𬚽	mwke
𬚾	etrt
𬚿	mwws
𬛀	ynea
𬛁	evfb
𬛂	egvh
𬛃	mwwj
𬛄	ehjg
𬛅	emfk
𬛆	eqaj
𬛇	eyvw
𬛈	mwwf
𬛉	uxec
𬛊	euey
𬛋	eyvb
𬛌	mwwt
𬛍	edwi
𬛎	mwwy
𬛏	uxeb
𬛐	eton
𬛑	evcq
𬛒	eifj
𬛓	ecce
𬛔	ddfe
𬛕	swwe
𬛖	eujg
𬛗	euny
𬛘	eusf
𬛙	edeh
𬛚	eaas
𬛛	uxew
𬛜	epnm
𬛝	ecke
𬛞	eauf
𬛟	efce
𬛠	ycev
𬛡	ejgi
𬛢	nfah
𬛣	ahkh
𬛤	wfah
𬛥	ahnd
𬛦	ahnu
𬛧	ahnb
𬛨	qkxh
𬛩	ahnf
𬛪	ahkj
𬛫	ahnj
𬛬	thdj
𬛭	dhdh
𬛮	thgr	thur
𬛯	thdj
𬛰	thgi
𬛱	gcfw
𬛲	tagf
𬛳	gcff
𬛴	gcfi
𬛵	gcfi
𬛶	gcfw
𬛷	gcfw
𬛸	vaf
𬛹	vnrt
𬛺	vqak	qgqk	wfqk
𬛻	vypt	wfyt
𬛼	vgnl	wfgl
𬛽	vqql	wfql
𬛾	vnhv
𬛿	vhnn	qghn	wfhn
𬜀	vhpt	qght	wfht
𬜁	vvkc	wfvc
𬜂	vssg	qgsg	wfsg
𬜃	vmgm	qgmm	wfmm
𬜄	vssq	qgsq	wfsq
𬜅	tdhk
𬜆	tdtp
𬜇	tdyg
𬜈	tdyf
𬜉	tdln
𬜊	tdmj
𬜋	wfkk
𬜌	tdyb
𬜍	wfko
𬜎	tdmp
𬜏	tdsi
𬜐	tdww
𬜑	teln
𬜒	tenn
𬜓	tewb
𬜔	tedp
𬜕	temm
𬜖	tepa
𬜗	teak
𬜘	tefw
𬜙	tehh
𬜚	teii
𬜛	tetc
𬜜	teti
𬜝	qcch
𬜞	qcdd
𬜟	gmyc
𬜠	aqb
𬜡	amj
𬜢	aqyu
𬜣	afjj
𬜤	ajcu
𬜥	amqu
𬜦	afaj
𬜧	anty
𬜨	amqu
𬜩	awjf
𬜪	armj
𬜫	avnu
𬜬	aukf
𬜭	apta
𬜮	avvf
𬜯	agmw
𬜰	akyu
𬜱	atdj
𬜲	aqej
𬜳	awgy
𬜴	annw
𬜵	aykf
𬜶	apqb
𬜷	auck
𬜸	angi
𬜹	avyb
𬜺	axnf	axng	axny
𬜻	agwh
𬜼	agmn
𬜽	adaj
𬜾	ajcm
𬜿	algy
𬝀	atff
𬝁	aqgf
𬝂	apkq
𬝃	aplt
𬝄	apgy
𬝅	ayrj
𬝆	audn
𬝇	aybf
𬝈	avgh
𬝉	accc
𬝊	axry
𬝋	abju
𬝌	asrf
𬝍	agqi	agti
𬝎	amwl
𬝏	ajdt
𬝐	ahko
𬝑	awdu
𬝒	awtj
𬝓	awyk
𬝔	atrc
𬝕	atla
𬝖	angg
𬝗	anye
𬝘	auxx
𬝙	aprx
𬝚	agxi
𬝛	agdg
𬝜	agmw
𬝝	abwv
𬝞	asbf
𬝟	algy
𬝠	amad
𬝡	ajee
𬝢	awgd
𬝣	atmd
𬝤	aeud
𬝥	aqfw
𬝦	atgw
𬝧	awga	awya	awua
𬝨	awwf
𬝩	auqr
𬝪	aytp
𬝫	apjd
𬝬	aphw
𬝭	auca
𬝮	aouf
𬝯	aprw
𬝰	avyb
𬝱	xjad
𬝲	avtj
𬝳	anae
𬝴	acwy
𬝵	alqw
𬝶	aawj
𬝷	affn
𬝸	aghi
𬝹	afvf
𬝺	axfw
𬝻	adye
𬝼	aaah
𬝽	agte
𬝾	aipf
𬝿	ampu
𬞀	ajde
𬞁	ajkq
𬞂	aqrd	aqud
𬞃	aqdd
𬞄	awyf
𬞅	aqtp
𬞆	apun
𬞇	aiqm
𬞈	ayaw
𬞉	aiee
𬞊	apds
𬞋	ailr
𬞌	abqm
𬞍	axfi
𬞎	aitq
𬞏	algg
𬞐	akhk
𬞑	akff
𬞒	ajmk
𬞓	awyn
𬞔	apun
𬞕	augi
𬞖	aygh
𬞗	audk
𬞘	abkm
𬞙	axxj
𬞚	adyf
𬞛	afay
𬞜	ajqo
𬞝	ahff
𬞞	akhq
𬞟	ahim
𬞠	awsy
𬞡	aeuh
𬞢	aesw
𬞣	atce
𬞤	aynp
𬞥	aied
𬞦	aowa
𬞧	auxn
𬞨	aoev	aoej
𬞩	aymf
𬞪	autq
𬞫	aijl
𬞬	avpk
𬞭	aaho
𬞮	alph
𬞯	ahjt
𬞰	ahjv
𬞱	alah
𬞲	ahan
𬞳	aeun
𬞴	arqf
𬞵	aqve
𬞶	awgn
𬞷	ayqg
𬞸	apaq
𬞹	ayjo
𬞺	ovaj
𬞻	axrh
𬞼	axwy
𬞽	avjc
𬞾	abde
𬞿	glwd
𬟀	aeed
𬟁	agkg
𬟂	adec
𬟃	aoge
𬟄	ahim
𬟅	akhj
𬟆	awun
𬟇	adil
𬟈	aeeq
𬟉	aign
𬟊	aysn
𬟋	axfj
𬟌	abuf
𬟍	axjy
𬟎	agar
𬟏	axf	amgg
𬟐	akhm
𬟑	arwo
𬟒	atem
𬟓	atgo
𬟔	anun
𬟕	axfw
𬟖	dujk
𬟗	ahjv
𬟘	atgn
𬟙	aeuy
𬟚	aiko
𬟛	povj
𬟜	gqjj
𬟝	ajto
𬟞	atjn
𬟟	acbe
𬟠	agaj
𬟡	ahdt
𬟢	auky
𬟣	aigm
𬟤	aywo
𬟥	gkis
𬟦	adec
𬟧	hadi
𬟨	hafw
𬟩	haoi
𬟪	hamq
𬟫	hami
𬟬	mnmm
𬟭	haml
𬟮	haii
𬟯	hatx
𬟰	xsgm
𬟱	halo
𬟲	xfum
𬟳	halh
𬟴	jmh
𬟵	jtmn
𬟶	jfyy
𬟷	jfjh
𬟸	jrcy
𬟹	jwxn
𬟺	wwju
𬟻	juy
𬟼	jgsy
𬟽	jaiy
𬟾	janw
𬟿	jghg
𬠀	jrg
𬠁	judy
𬠂	jsg
𬠃	jxxf
𬠄	jlmh
𬠅	jivg
𬠆	qxhj
𬠇	jiwy
𬠈	jamy
𬠉	kqrj
𬠊	jwnw
𬠋	jiit
𬠌	jvfb
𬠍	jvyn
𬠎	jffh
𬠏	jrug
𬠐	jmum
𬠑	jwyk
𬠒	jrmh
𬠓	jtbg
𬠔	jtoh
𬠕	jtfx
𬠖	jwyn
𬠗	jukg
𬠘	iynj
𬠙	juwf
𬠚	jihc
𬠛	xfij
𬠜	jsjg
𬠝	juej
𬠞	jnuh	jnuj
𬠟	jaff
𬠠	madj
𬠡	jwhe
𬠢	jpyg
𬠣	jpwk
𬠤	ijju
𬠥	jgan
𬠦	jhah
𬠧	jujq
𬠨	jvfl
𬠩	jftb
𬠪	jbcg	jbcf
𬠫	jaje
𬠬	jafy
𬠭	jhxi
𬠮	jwwf
𬠯	jldd
𬠰	vqqj	wfqj
𬠱	txgj
𬠲	jgrd
𬠳	jalq
𬠴	jrlh
𬠵	jpnj
𬠶	jpxu
𬠷	ujfj
𬠸	eeuj	tuej
𬠹	wgkj
𬠺	juda
𬠻	jlxy
𬠼	gqjl
𬠽	tyfh
𬠾	tafh
𬠿	thfh
𬡀	tweh
𬡁	tkkh
𬡂	puty
𬡃	pufg
𬡄	uneu
𬡅	pubh
𬡆	punn
𬡇	yceu
𬡈	pudh
𬡉	pudb
𬡊	pucn
𬡋	puah
𬡌	wyce
𬡍	puqg
𬡎	puqv
𬡏	yueu
𬡐	xjye
𬡑	ydee
𬡒	pugw
𬡓	rvye
𬡔	pujh
𬡕	puqs
𬡖	pums
𬡗	yoeu
𬡘	puud
𬡙	puaf
𬡚	yate
𬡛	wtye
𬡜	puut
𬡝	yvte
𬡞	puac
𬡟	puaq
𬡠	pulq
𬡡	ywye
𬡢	putd
𬡣	puuk
𬡤	ooye
𬡥	puhm
𬡦	putc
𬡧	puwk
𬡨	puye
𬡩	puhg
𬡪	pufg
𬡫	ykke
𬡬	putl
𬡭	ywke
𬡮	pueo
𬡯	puyj
𬡰	pujo
𬡱	putj
𬡲	sqse
𬡳	punf
𬡴	puxh
𬡵	puay
𬡶	pulf
𬡷	putm
𬡸	dnsd
𬡹	swrf
𬡺	svfc
𬡻	sout
𬡼	qahq
𬡽	hqan
𬡾	imkq
𬡿	jvtq
𬢀	rqwq
𬢁	hqwv
𬢂	jvtq
𬢃	fwfq
𬢄	hqlw
𬢅	yntq
𬢆	hamq
𬢇	cmqb
𬢈	aimq
𬢉	gmhq
𬢊	ngkq
𬢋	iqmq
𬢌	fnmq
𬢍	gmiq
𬢎	ftjq
𬢏	adwq
𬢐	dhvq
𬢑	amdq
𬢒	pjuq
𬢓	umiq
𬢔	wgkq
𬢕	qedt
𬢖	qeiq
𬢗	wwke
𬢘	qewh
𬢙	ynky
𬢚	dyd
𬢛	yqn
𬢜	yay
𬢝	gwyf
𬢞	yqhh
𬢟	yhcy
𬢠	ynfh
𬢡	yfiy
𬢢	ycah
𬢣	ydnt
𬢤	uqwy
𬢥	yaet
𬢦	yftn
𬢧	kkyf
𬢨	ypvg
𬢩	yibh
𬢪	ydtf
𬢫	ysfy
𬢬	ydqy
𬢭	ytmt
𬢮	yhhy
𬢯	mmyf
𬢰	yyny
𬢱	yugc
𬢲	ybib
𬢳	ycde
𬢴	yuqv
𬢵	yhmy
𬢶	ywvl
𬢷	ywgq
𬢸	ytoc
𬢹	ycuh
𬢺	fjty
𬢻	yxlw
𬢼	yajh
𬢽	ydmo
𬢾	ydff
𬢿	yawk
𬣀	tfny
𬣁	ypdk
𬣂	yudh
𬣃	ytry
𬣄	yvfj
𬣅	ydnl
𬣆	yswp
𬣇	yaqo
𬣈	ywae
𬣉	yvfj	yvhh
𬣊	yaec
𬣋	ywgf
𬣌	yafb
𬣍	ylgf
𬣎	ywgg
𬣏	vqey	qgqy	wfqy
𬣐	yaxn
𬣑	ynwy
𬣒	yajj
𬣓	ywyd
𬣔	ytnh
𬣕	ysaw
𬣖	yugl
𬣗	yxyx
𬣘	yxys
𬣙	ygfh
𬣚	ykg
𬣛	yfcy
𬣜	ytfn
𬣝	yqug
𬣞	ypgg
𬣟	yufh
𬣠	yafg
𬣡	ygt
𬣢	ywbn
𬣣	yygg
𬣤	yyxy
𬣥	ybhc
𬣦	yxln
𬣧	yxjh
𬣨	ydat
𬣩	ydeg
𬣪	ymqy
𬣫	ylft
𬣬	ylkg
𬣭	yivg
𬣮	yqkg
𬣯	ywtf
𬣰	ythg
𬣱	yyth
𬣲	yuah
𬣳	yvey
𬣴	ydnp
𬣵	ydpy
𬣶	ydtf
𬣷	ygki
𬣸	yjfh
𬣹	ykhy
𬣺	ytah
𬣻	ytfp
𬣼	yyve
𬣽	ylpy
𬣾	yajg
𬣿	yapl
𬤀	yham
𬤁	yqrm
𬤂	ypws
𬤃	yudb
𬤄	ycde
𬤅	ybkg
𬤆	yxfm
𬤇	ysfg
𬤈	ygkh
𬤉	ykhm
𬤊	yjgh
𬤋	yqrn
𬤌	ytfv
𬤍	yrgg
𬤎	ypgg
𬤏	yyac
𬤐	yskk
𬤑	ygkh
𬤒	yfcl
𬤓	yftj
𬤔	ymdl
𬤕	yjng
𬤖	yplp
𬤗	yyos
𬤘	yswi
𬤙	yhah
𬤚	ymmv
𬤛	yuqv
𬤜	ynfj
𬤝	ygjn
𬤞	yfpu
𬤟	ydui
𬤠	ykkm
𬤡	ytmd
𬤢	yusf
𬤣	yybt
𬤤	yulj
𬤥	ynnw
𬤦	ykhp
𬤧	yhhd
𬤨	ykks
𬤩	yxth
𬤪	ylip
𬤫	yype
𬤬	yxxn
𬤭	ydhn
𬤮	ytfm
𬤯	ypfh
𬤰	yaky
𬤱	yrqy
𬤲	wwkc
𬤳	wwka
𬤴	wwkm
𬤵	fptk
𬤶	nygu
𬤷	gkuf
𬤸	gkuh
𬤹	mgkn
𬤺	dhdn
𬤻	een
𬤼	qbeu
𬤽	enfg
𬤾	sfey
𬤿	egkg
𬥀	evtk
𬥁	bceu
𬥂	eakg
𬥃	vkbe
𬥄	ebcc
𬥅	hheu
𬥆	qjeh
𬥇	ithe
𬥈	eedm
𬥉	eetq
𬥊	eeaw
𬥋	eejt
𬥌	eeqe
𬥍	eeac
𬥎	cmu
𬥏	mwvn
𬥐	wqmu
𬥑	qbmu
𬥒	vtmu	vtmi
𬥓	mufh
𬥔	rman
𬥕	mwgn
𬥖	mhfg
𬥗	mwwf
𬥘	mtfk
𬥙	pwkm
𬥚	xjjm
𬥛	mdsk
𬥜	mmde
𬥝	rmhm
𬥞	mcde
𬥟	mnjw
𬥠	afmy
𬥡	hqrm
𬥢	mefc
𬥣	wvmb
𬥤	mpgg
𬥥	mpey
𬥦	fitm
𬥧	mtxt
𬥨	mqdc
𬥩	kmpy
𬥪	fkum
𬥫	ogum
𬥬	wvmy
𬥭	mluj
𬥮	akfm
𬥯	wvmh
𬥰	qaqm	qamm
𬥱	awym
𬥲	mgke
𬥳	mwbn
𬥴	mafg
𬥵	mtbn
𬥶	mhcy
𬥷	mqvh
𬥸	mkkh
𬥹	mwfk
𬥺	majv
𬥻	mdmd
𬥼	mmdj
𬥽	mwnd
𬥾	mjtl
𬥿	mdjf
𬦀	mgke
𬦁	fowv
𬦂	fove
𬦃	ftjo
𬦄	fofq
𬦅	fhnr
𬦆	fhfy
𬦇	gifh
𬦈	fhed
𬦉	fhdd
𬦊	fhhq
𬦋	fhyi
𬦌	fhdt
𬦍	fhqu
𬦎	fhah
𬦏	fhhv	fhvv
𬦐	fhqk
𬦑	fhcd
𬦒	fhee
𬦓	fhpi
𬦔	fhfd
𬦕	fhem
𬦖	fhpl
𬦗	fhni
𬦘	fhan
𬦙	fhfg
𬦚	fhld
𬦛	fhma
𬦜	fhul
𬦝	fhju
𬦞	fhnf
𬦟	fhfe
𬦠	khen
𬦡	khwh
𬦢	khun
𬦣	khdl
𬦤	khat
𬦥	khmy
𬦦	khry
𬦧	khwx
𬦨	khkb
𬦩	khqv
𬦪	khvk
𬦫	khch
𬦬	khfn
𬦭	skhu
𬦮	khbg
𬦯	khgw
𬦰	khdj
𬦱	khre
𬦲	khlh
𬦳	khee
𬦴	khum
𬦵	khxy
𬦶	khgj
𬦷	khax
𬦸	khjx
𬦹	khts
𬦺	khyc
𬦻	khxm
𬦼	ftjh
𬦽	khsv
𬦾	khjq
𬦿	khwy
𬧀	khuf
𬧁	ireh
𬧂	khpg
𬧃	khuc
𬧄	kham
𬧅	khgf
𬧆	khha
𬧇	khiv
𬧈	khuu
𬧉	khcs
𬧊	khal
𬧋	khlr
𬧌	khhe
𬧍	khtm
𬧎	khuq
𬧏	khul
𬧐	khxl
𬧑	khfl
𬧒	khkn
𬧓	kheh
𬧔	khqj
𬧕	khqh
𬧖	khup
𬧗	khxv
𬧘	khos
𬧙	khqj
𬧚	khfm
𬧛	khai
𬧜	khac
𬧝	khmm
𬧞	khfe
𬧟	khge
𬧠	tmdn
𬧡	tmdu
𬧢	tmdx
𬧣	tmda
𬧤	tmdl
𬧥	tmdd
𬧦	tmdw
𬧧	tmdx
𬧨	tmdx
𬧩	tmdy
𬧪	tmds
𬧫	tmdn
𬧬	tmdl
𬧭	tmde
𬧮	tmdw
𬧯	tmdi
𬧰	tmdo
𬧱	lxxn
𬧲	sklj
𬧳	ljnn
𬧴	lniy
𬧵	lthc
𬧶	lqqt
𬧷	lblg
𬧸	lqmd
𬧹	luda
𬧺	lqbt
𬧻	lvlh	kgkl
𬧼	lwnx
𬧽	lumk
𬧾	fllh
𬧿	lumh
𬨀	lnfa
𬨁	ltfn
𬨂	lqan
𬨃	lbcy
𬨄	lmdy
𬨅	lncy
𬨆	amyl
𬨇	lynw
𬨈	lqkq
𬨉	lqlg
𬨊	ntfl
𬨋	nhdl
𬨌	lrtf
𬨍	ljqn
𬨎	lusg
𬨏	lnhe
𬨐	lrqc
𬨑	lccs
𬨒	lamw
𬨓	lvjs
𬨔	lnku
𬨕	lfph
𬨖	unn
𬨗	fiuh
𬨘	untt
𬨙	uxjh
𬨚	cngu
𬨛	ugkm
𬨜	fpd
𬨝	fwpi
𬨞	hcpi
𬨟	wvpv
𬨠	tapk
𬨡	mmgp
𬨢	upd
𬨣	ynip
𬨤	gjgp
𬨥	qspi
𬨦	gdkp
𬨧	gxxp
𬨨	kmwp
𬨩	tmpv
𬨪	emhp
𬨫	wqdp
𬨬	lnxp
𬨭	audp
𬨮	gjip
𬨯	qtrp
𬨰	qrjp
𬨱	begp
𬨲	bkcp
𬨳	syxp
𬨴	ackp
𬨵	rtpp
𬨶	eghp
𬨷	wyvp
𬨸	eclp
𬨹	ckrp
𬨺	lhpd
𬨻	gkip
𬨼	gjhp
𬨽	wgjp
𬨾	tuxp
𬨿	ofcp
𬩀	gikp
𬩁	fckp
𬩂	fadp
𬩃	hamp
𬩄	euep
𬩅	iftp
𬩆	ivlp
𬩇	lugp
𬩈	vqrp
𬩉	gkip
𬩊	sstp
𬩋	syyp
𬩌	iqlp
𬩍	qqop
𬩎	pykp
𬩏	yigp
𬩐	cebp
𬩑	afwp
𬩒	gjhp
𬩓	dhgp
𬩔	jmhp
𬩕	mnmp
𬩖	ipkp
𬩗	mdmp
𬩘	wgjp
𬩙	tfkp
𬩚	vdfp
𬩛	cfep
𬩜	xtdp
𬩝	alpp
𬩞	awnp
𬩟	mnmp
𬩠	khgp
𬩡	eerp
𬩢	ynmp
𬩣	yjpd	yvup
𬩤	dajp
𬩥	eswp
𬩦	ayap
𬩧	mnmp
𬩨	kklp
𬩩	eyjp
𬩪	pdup
𬩫	mwnp
𬩬	qonp
𬩭	tfkp
𬩮	nkup
𬩯	gkip
𬩰	lakp
𬩱	wnnp
𬩲	rpwp
𬩳	lbh
𬩴	kccy
𬩵	khbh
𬩶	trbh
𬩷	hkbh
𬩸	jhbh
𬩹	wdbh
𬩺	awkc
𬩻	qsbh
𬩼	mgmb
𬩽	vfbh
𬩾	gobh
𬩿	hfbh
𬪀	jvbh
𬪁	qytc
𬪂	trnb
𬪃	efbh
𬪄	vfbh
𬪅	dwfb
𬪆	debh
𬪇	akgb
𬪈	jxxb
𬪉	jqrb
𬪊	tkkb
𬪋	aqtb
𬪌	jgqb
𬪍	qyvb
𬪎	rsbh
𬪏	wgob
𬪐	uwjb
𬪑	anab
𬪒	kfub
𬪓	wynb
𬪔	ivwb
𬪕	ajeb
𬪖	ahqb
𬪗	lgkb
𬪘	yxtb
𬪙	ylkb
𬪚	ywwb
𬪛	ntfb
𬪜	yjbh	yvub
𬪝	awfb
𬪞	thlb
𬪟	thpb
𬪠	gkkb
𬪡	rlgb
𬪢	qqwb
𬪣	haqb
𬪤	txgb
𬪥	lrlb
𬪦	sgfj
𬪧	sgaq
𬪨	sgdt
𬪩	sgpe
𬪪	sgsg
𬪫	sguj
𬪬	sguh
𬪭	sgsf
𬪮	sgda
𬪯	sgjq
𬪰	qkxg
𬪱	sgnf
𬪲	sgyl
𬪳	sgtk
𬪴	sgto
𬪵	itfg
𬪶	sgyg
𬪷	sggi
𬪸	sgjo
𬪹	qjxg
𬪺	toyt
𬪻	tofc
𬪼	tgjq
𬪽	tgjh
𬪾	tgjb
𬪿	gfgf	ghgf
𬫀	jfcf
𬫁	fotf
𬫂	qdln
𬫃	qgg
𬫄	qthn
𬫅	wbqf
𬫆	qtdc
𬫇	qafg
𬫈	kbqf
𬫉	qeh
𬫊	qwtf
𬫋	qrgc	qtdc
𬫌	qqay
𬫍	qadt
𬫎	fvyq
𬫏	qxjg
𬫐	qhiy
𬫑	qtfh
𬫒	qudy
𬫓	qvbg
𬫔	fqrq
𬫕	qset
𬫖	qfeg
𬫗	qacy
𬫘	qmqw
𬫙	qmgn
𬫚	qkmw
𬫛	qwtf
𬫜	wkbq
𬫝	qyfy
𬫞	qoah
𬫟	qvoy
𬫠	qikg
𬫡	qbkg
𬫢	qgfl
𬫣	qadh
𬫤	qlfn
𬫥	qtbg
𬫦	qwgb
𬫧	pyqq
𬫨	ooqf
𬫩	qyqy
𬫪	qyxh
𬫫	qylk
𬫬	qbyl
𬫭	qdjf
𬫮	qaeh
𬫯	qadt
𬫰	qawf
𬫱	qwcn
𬫲	qytb
𬫳	qdwi
𬫴	qdji
𬫵	qgxi
𬫶	qfjw
𬫷	qdfk
𬫸	qltd
𬫹	qqjx
𬫺	qwhd
𬫻	qwqu
𬫼	ycem
𬫽	qyte
𬫾	qcdi
𬫿	qdha
𬬀	qmmm
𬬁	qtjh
𬬂	qtug
𬬃	qrmh
𬬄	qpdk
𬬅	qfpu
𬬆	lcfq
𬬇	lllq
𬬈	qaqs
𬬉	qkdd
𬬊	qqdo
𬬋	qfwk
𬬌	qaag
𬬍	qsjr
𬬎	qlfe
𬬏	qhjr
𬬐	qtgy
𬬑	qyxy
𬬒	qbce
𬬓	qgrd
𬬔	qxth
𬬕	qlfe
𬬖	qrqf
𬬗	qvhl
𬬘	yclf
𬬙	qanf
𬬚	qhae
𬬛	qtel
𬬜	hobq
𬬝	qelq
𬬞	qtdi
𬬟	qyli
𬬠	qxgq
𬬡	qato
𬬢	qnhh
𬬣	qpuj
𬬤	qkkk
𬬥	qgke
𬬦	qxyn
𬬧	qfh
𬬨	qfnn
𬬩	qay
𬬪	qkg
𬬫	qxxn
𬬬	qfnh
𬬭	qwxn
𬬮	qtay
𬬯	qtfg
𬬰	qwbn
𬬱	qrh
𬬲	qrhy
𬬳	qtnt
𬬴	qtdy
𬬵	qpqn
𬬶	qyly
𬬷	qdg
𬬸	qsyy
𬬹	qjhh
𬬺	qegg
𬬻	qhnt
𬬼	qogg
𬬽	qthf
𬬾	qpsh
𬬿	qvkg
𬭀	qckg
𬭁	qxgu
𬭂	qxcy
𬭃	qgif
𬭄	qsg
𬭅	qrgk
𬭆	qmsy
𬭇	qwfc
𬭈	qpta
𬭉	qyjh
𬭊	qsfg
𬭋	qaah
𬭌	qkgd
𬭍	qjfh
𬭎	qpdc
𬭏	qbjg
𬭐	qctd
𬭑	qgkh
𬭒	qapm
𬭓	qmaw
𬭔	qhwb
𬭕	qmfk
𬭖	qeeg
𬭗	qtvg
𬭘	qwfk
𬭙	qujf
𬭚	qybg
𬭛	qihc
𬭜	qynd
𬭝	qcde
𬭞	qdbg
𬭟	qdwd
𬭠	qsjg
𬭡	qavk
𬭢	qkhm
𬭣	qriy
𬭤	qwnd
𬭥	qqrn
𬭦	qdff
𬭧	qhqk
𬭨	qwnp
𬭩	qwcn
𬭪	qpdk
𬭫	qnae
𬭬	qdhv
𬭭	qdht
𬭮	qagw
𬭯	qumt
𬭰	qpgw
𬭱	qokn
𬭲	qvjs
𬭳	qfkk
𬭴	qdhi
𬭵	qfke
𬭶	qlfo
𬭷	qipt
𬭸	qoqh
𬭹	qngw
𬭺	qsfj
𬭻	qryt
𬭼	quep
𬭽	qnku
𬭾	qtha
𬭿	qtdj
𬮀	qvmw	qwfw
𬮁	qaif
𬮂	qvmm	qwfm
𬮃	qthi
𬮄	dtdj
𬮅	ulv
𬮆	ubv
𬮇	udi
𬮈	uqi
𬮉	ubmk
𬮊	udww
𬮋	uqtt
𬮌	yfhu
𬮍	uiaw
𬮎	ugdu
𬮏	utmf
𬮐	uyte
𬮑	uvfj
𬮒	upnm
𬮓	ugmi
𬮔	gliq
𬮕	uosf
𬮖	uilp
𬮗	uhae
𬮘	uwy
𬮙	udnv
𬮚	uad
𬮛	uhd
𬮜	ugdi
𬮝	udi
𬮞	uwyn
𬮟	uoi
𬮠	uskd
𬮡	uqhi
𬮢	uawi
𬮣	uagd
𬮤	uwgk
𬮥	uwww
𬮦	uudi
𬮧	uiyn
𬮨	ufoi
𬮩	utxi
𬮪	uiit
𬮫	ugaf
𬮬	uged
𬮭	ufwq
𬮮	udsk
𬮯	uffh
𬮰	ubsk
𬮱	usfd
𬮲	usvd
𬮳	ukkk
𬮴	uujd
𬮵	ubve
𬮶	ugah
𬮷	ujfh
𬮸	uujf
𬮹	uwgu
𬮺	bcg
𬮻	bqng
𬮼	bqwy
𬮽	bnqy
𬮾	brgg
𬮿	bmnn
𬯀	byjh
𬯁	buh
𬯂	byg
𬯃	biqw
𬯄	bdaf
𬯅	bagw
𬯆	bjqr
𬯇	brfg
𬯈	wnnm
𬯉	bqg
𬯊	bcde
𬯋	badn
𬯌	bdwj
𬯍	bivi
𬯎	bkhm
𬯏	briy
𬯐	bagw
𬯑	bwuk
𬯒	berm
𬯓	bxgc
𬯔	bgjf
𬯕	bjaf
𬯖	bwyg
𬯗	btln
𬯘	bcce
𬯙	becc
𬯚	busd
𬯛	bynd
𬯜	bskw
𬯝	btgn
𬯞	bqvc
𬯟	bvft
𬯠	bpwi
𬯡	bawi
𬯢	bsgt
𬯣	bskj
𬯤	btvm
𬯥	bajl
𬯦	bluu
𬯧	bxga
𬯨	bxyx
𬯩	bskm
𬯪	wyhf
𬯫	wypf
𬯬	iqwy
𬯭	wyqf
𬯮	vcwy
𬯯	ftjy
𬯰	wycn
𬯱	pwyk
𬯲	qbty
𬯳	pwyw
𬯴	wyny
𬯵	mmwy
𬯶	vuwy	qguy	wfuy
𬯷	uday
𬯸	fvyu
𬯹	fmcu
𬯺	fcbj
𬯻	fymh
𬯼	ftjj
𬯽	fixn
𬯾	fsfc
𬯿	fjef
𬰀	fiqn
𬰁	fyjf
𬰂	fifc
𬰃	figs
𬰄	fdmu
𬰅	fwgj
𬰆	fiqh
𬰇	fcby
𬰈	fjff
𬰉	flve
𬰊	fypu
𬰋	fgss
𬰌	fwyj
𬰍	fvsh
𬰎	ffcf
𬰏	fyek
𬰐	fout
𬰑	fkki
𬰒	fpdw
𬰓	fpwi
𬰔	fbqn
𬰕	fafc
𬰖	fvqq
𬰗	gean
𬰘	gerg
𬰙	djdv
𬰚	djdu
𬰛	vkdd
𬰜	gkdd
𬰝	temd
𬰞	djdl
𬰟	ynjd
𬰠	gsdd
𬰡	dmjq
𬰢	pntd
𬰣	ilrd
𬰤	afxf
𬰥	afgw
𬰦	afld
𬰧	afue
𬰨	affc
𬰩	afao
𬰪	nhkh
𬰫	fanh
𬰬	nhkh
𬰭	nhkh
𬰮	nhkl
𬰯	nhkf
𬰰	nhke
𬰱	fnhf
𬰲	fnhq
𬰳	fnhk
𬰴	fnhf
𬰵	fnhn
𬰶	fnhn
𬰷	fnhy
𬰸	srmh
𬰹	ujmg
𬰺	ujog
𬰻	ujty
𬰼	ujvj
𬰽	whtj
𬰾	ujwa
𬰿	vdmy
𬱀	gfdm
𬱁	ynim
𬱂	ntdm
𬱃	qkdm
𬱄	xynm
𬱅	sndm
𬱆	dqdm
𬱇	wvfm
𬱈	lkcm
𬱉	jvtm
𬱊	afim
𬱋	udlm
𬱌	jvtm
𬱍	kdmu
𬱎	sdmk
𬱏	uwym
𬱐	ghlm
𬱑	kkpm
𬱒	dmqy
𬱓	vdmy
𬱔	dndm
𬱕	qcdm
𬱖	mdmy
𬱗	hkdm
𬱘	rydm
𬱙	uddm
𬱚	ntdm
𬱛	dmdm
𬱜	didm
𬱝	jxdm
𬱞	kkdm
𬱟	qdbm
𬱠	tddm
𬱡	esdm
𬱢	pldm
𬱣	mwym
𬱤	qakm
𬱥	cedm
𬱦	adwm
𬱧	dmfs
𬱨	djnm
𬱩	lkcm
𬱪	wnnm
𬱫	pghm
𬱬	cdem
𬱭	afdm
𬱮	xxmm
𬱯	uthm
𬱰	egim
𬱱	udum
𬱲	rpwm
𬱳	wgkm
𬱴	mtjf
𬱵	mqfh
𬱶	mfxn
𬱷	mqnw
𬱸	mqat
𬱹	mfux
𬱺	qbmq
𬱻	umrt	umfg
𬱼	mnmq
𬱽	mqth
𬱾	mqss
𬱿	mqag
𬲀	mqqn
𬲁	mfff
𬲂	mfwj
𬲃	mfgi
𬲄	mfpk
𬲅	mqdi
𬲆	mqck
𬲇	wgef
𬲈	mfvw	mfww
𬲉	nurd
𬲊	djdu
𬲋	wpfw	wyvw
𬲌	wpgh	wyvh
𬲍	wpwv	wyvv
𬲎	wptn	wyvn
𬲏	fawe
𬲐	wpdt	wyvt
𬲑	wpvj	wyvj
𬲒	wpxd	wyvd
𬲓	wpwt	wyvt
𬲔	wpyk	wyvk
𬲕	lrwe
𬲖	wyvw
𬲗	wpdv	wyvv
𬲘	wpsv	wyvv
𬲙	wpua	wyva
𬲚	wpda	wyva
𬲛	wpar	wyvr
𬲜	wpit	wyvt
𬲝	wpuf	wyvf
𬲞	wpvs	wyvs
𬲟	wyvw
𬲠	wpwn	wyvn
𬲡	wpnn	wyvn
𬲢	wpfq	wyvq
𬲣	wptr	wyvr
𬲤	wphc	wyvc
𬲥	qnhy
𬲦	qnwy
𬲧	qnfn
𬲨	qngf
𬲩	qndb
𬲪	qnww
𬲫	qnhk
𬲬	qnkw
𬲭	qneg
𬲮	qnqy
𬲯	qnqk
𬲰	qntr
𬲱	qnpx
𬲲	qnps
𬲳	qnch
𬲴	qnmk
𬲵	qnqc
𬲶	qnyj
𬲷	qnve
𬲸	qnfp
𬲹	qnan
𬲺	qneb
𬲻	qnut
𬲼	qndn
𬲽	qnaw
𬲾	qnld
𬲿	qnmd
𬳀	qnqk
𬳁	qnqe
𬳂	qncc
𬳃	qngl
𬳄	qnff
𬳅	qnde
𬳆	qnth
𬳇	qnpg
𬳈	qnkn
𬳉	qnjn
𬳊	qnev
𬳋	qntn
𬳌	qntd
𬳍	qnyk
𬳎	qnda
𬳏	qnaw
𬳐	qnmi
𬳑	qnji
𬳒	qnwu
𬳓	qnyy
𬳔	qnyc
𬳕	utht
𬳖	uthb
𬳗	gehh
𬳘	uthe
𬳙	uthm
𬳚	uthh
𬳛	utht
𬳜	tjgq
𬳝	eytj
𬳞	tjpb
𬳟	tjfm
𬳠	totj
𬳡	tjdn
𬳢	tmdj
𬳣	tjuy
𬳤	tjak
𬳥	tjwo
𬳦	tjwm
𬳧	xtyj
𬳨	cvg
𬳩	chcy
𬳪	vtcy
𬳫	clll
𬳬	cgjq
𬳭	mumc
𬳮	cyiy
𬳯	ccde
𬳰	cuql
𬳱	ckhm
𬳲	cnud
𬳳	cmqy
𬳴	cguh
𬳵	cgig
𬳶	cmkg
𬳷	crcy
𬳸	ipcf
𬳹	cdfn
𬳺	cgkq
𬳻	cagg
𬳼	cdeg
𬳽	ctfq
𬳾	cqqy
𬳿	cwty
𬴀	cyve
𬴁	cmdf
𬴂	cdjd
𬴃	cdhd
𬴄	cjtg
𬴅	cupy
𬴆	cakg
𬴇	cgkw
𬴈	cdht
𬴉	cdui
𬴊	coqh
𬴋	cfag
𬴌	cape
𬴍	cyno
𬴎	cgks
𬴏	cpfh
𬴐	caky
𬴑	game
𬴒	mewk
𬴓	tcme
𬴔	ypkq
𬴕	ymkn
𬴖	yjfx
𬴗	yjfn
𬴘	yjfh
𬴙	jtak
𬴚	ymki
𬴛	gkmh
𬴜	yjfi
𬴝	ymkq
𬴞	ymkh
𬴟	ymkh
𬴠	yjfg
𬴡	yjft
𬴢	yjfj
𬴣	yjfy
𬴤	yjfd
𬴥	yjfj
𬴦	yjfg
𬴧	dega
𬴨	deaq
𬴩	depe
𬴪	deps
𬴫	dess
𬴬	deik
𬴭	deqj
𬴮	denh
𬴯	deyo
𬴰	hggm
𬴱	hggt
𬴲	gkmc
𬴳	gkkh
𬴴	gkmk
𬴵	gkmc
𬴶	gkme
𬴷	shgh
𬴸	xffh
𬴹	xesh
𬴺	xonh
𬴻	xoyh
𬴼	xjgh
𬴽	rqca
𬴾	rqhd	tlqh
𬴿	rqcb
𬵀	rqlk	tlql
𬵁	qogn
𬵂	qohy
𬵃	qody
𬵄	vyqo
𬵅	jqou
𬵆	qoiy
𬵇	qodt
𬵈	qoln
𬵉	qolf
𬵊	qowi
𬵋	isqo
𬵌	qoyi
𬵍	qofb
𬵎	qolh
𬵏	qotd
𬵐	qoyf
𬵑	qovp
𬵒	qolh
𬵓	qokh
𬵔	qokh
𬵕	qowx
𬵖	qocd
𬵗	qofy
𬵘	qoaf
𬵙	rqqo	tlqo
𬵚	qotf
𬵛	qoyw
𬵜	qosv
𬵝	qolx
𬵞	qojg	qoth
𬵟	qoyc
𬵠	qofi
𬵡	qogi
𬵢	qodt
𬵣	qoaf
𬵤	qorv
𬵥	qomx
𬵦	qoay
𬵧	qomy
𬵨	qppm
𬵩	qone
𬵪	qogn
𬵫	qolw
𬵬	qous
𬵭	qota
𬵮	qofp
𬵯	qogp
𬵰	qokq
𬵱	qoix
𬵲	qogc
𬵳	qoaq
𬵴	qoao
𬵵	qoye
𬵶	qogt
𬵷	qouw
𬵸	qoan
𬵹	qoye
𬵺	qovb
𬵻	qowh
𬵼	qmqo
𬵽	qofm
𬵾	qotf
𬵿	qoai
𬶀	qgjh
𬶁	qgwy
𬶂	qgfg
𬶃	qgdy
𬶄	qgqy
𬶅	qgat
𬶆	qgdh
𬶇	qgwj
𬶈	qgeg
𬶉	qgtf
𬶊	qggy	qggg
𬶋	qgqk
𬶌	qgwa
𬶍	qgpx
𬶎	qgab
𬶏	qgqb
𬶐	qgiq
𬶑	qgdp
𬶒	qgmn
𬶓	qgtp
𬶔	qgtk
𬶕	qgut
𬶖	qgdn
𬶗	qgal
𬶘	qgjb
𬶙	qgec
𬶚	qgec
𬶛	qguf
𬶜	qguk
𬶝	qgpb
𬶞	qgde
𬶟	qggj
𬶠	qggi
𬶡	qggu
𬶢	qgjg
𬶣	qgua
𬶤	qguh
𬶥	qgyx
𬶦	qgyb
𬶧	qgcs
𬶨	vcag
𬶩	qgjv
𬶪	qgup
𬶫	qgaw
𬶬	qghg
𬶭	qgwi
𬶮	qgfk
𬶯	qgas
𬶰	qgir
𬶱	qgji
𬶲	qgqe
𬶳	qgqj
𬶴	qguj
𬶵	qgle
𬶶	qgyo
𬶷	qglw
𬶸	qgfg
𬶹	qgdf
𬶺	qgay
𬶻	qgfe
𬶼	bwvo
𬶽	wvga
𬶾	wvgf
𬶿	xwvo
𬷀	wvgc
𬷁	awvo
𬷂	qfwo
𬷃	thgo
𬷄	ufwo
𬷅	wvgd
𬷆	wvgf
𬷇	mfwo
𬷈	wawo
𬷉	wawo
𬷊	wvgy
𬷋	wvgs
𬷌	pswo
𬷍	wvgk
𬷎	rgko
𬷏	whwo
𬷐	wvge
𬷑	vkwo
𬷒	ccco
𬷓	wvge
𬷔	dwvo
𬷕	gehg
𬷖	qkqo
𬷗	wygo
𬷘	ttfo
𬷙	iito
𬷚	pdco
𬷛	yogo
𬷜	wvgh
𬷝	dfio
𬷞	sswo
𬷟	wvga
𬷠	qswo
𬷡	pnho
𬷢	dmwo
𬷣	wvgj
𬷤	esko
𬷥	wvgv
𬷦	yiwo	yjio
𬷧	ylwo
𬷨	dfeo
𬷩	wyco
𬷪	wvgv
𬷫	pyjo
𬷬	pewo
𬷭	vtro
𬷮	fwfo
𬷯	iwyo
𬷰	wvgs
𬷱	gygo
𬷲	fhao
𬷳	vnao
𬷴	wgeo
𬷵	usro
𬷶	ylko
𬷷	oopo
𬷸	wvgv
𬷹	awyo
𬷺	qeyo
𬷻	qynn
𬷼	qqyg
𬷽	qynb
𬷾	aqyg
𬷿	qynw
𬸀	yqyg
𬸁	gnyg
𬸂	skqg
𬸃	gyqg
𬸄	dxqg
𬸅	qvqg
𬸆	tgqg
𬸇	lkqg
𬸈	gcfg
𬸉	amyg	atng	anqg
𬸊	wtfg
𬸋	trxg
𬸌	qsqg
𬸍	dtfg
𬸎	tjqg
𬸏	yvcg
𬸐	ysqg
𬸑	ukqg
𬸒	qynw
𬸓	aqag
𬸔	swcg
𬸕	mmqg
𬸖	ooqg
𬸗	viqg
𬸘	ajvg
𬸙	hitg
𬸚	qtyg
𬸛	rgqg
𬸜	ynmg
𬸝	ujqg
𬸞	ovqg
𬸟	ngcg
𬸠	sksg
𬸡	jtyg
𬸢	rdfg
𬸣	pfjg
𬸤	sfig
𬸥	dwvg
𬸦	yttg
𬸧	aukg
𬸨	adwg
𬸩	tmog
𬸪	tolg
𬸫	ybtg
𬸬	fpgg
𬸭	ajqg
𬸮	awgg
𬸯	nkug
𬸰	fwyg
𬸱	hhwg
𬸲	hlox	hlqx
𬸳	hloq	hlqq
𬸴	hlot	hlqt
𬸵	hlqk
𬸶	hlqj
𬸷	hlqd
𬸸	hlqa
𬸹	hlqt
𬸺	ynjn
𬸻	ynjr
𬸼	nxyx
𬸽	ynjb
𬸾	ynjj
𬸿	ynjs
𬹀	ynjq
𬹁	ynjh
𬹂	swww
𬹃	swwk
𬹄	swwo
𬹅	gtft
𬹆	gtaw
𬹇	gtfb
𬹈	gtie
𬹉	gtpq
𬹊	gtaw
𬹋	gtjx
𬹌	gtwn
𬹍	gtad
𬹎	gtuk
𬹏	yssk
𬹐	amwy
𬹑	amwf
𬹒	rraw
𬹓	amwn
𬹔	jcti
𬹕	lfom
𬹖	lfoe
𬹗	lfoo
𬹘	lfoc
𬹙	fhwo
𬹚	lfoj
𬹛	lfot
𬹜	ogum
𬹝	qxf	qmgv	txf	tmgv
𬹞	dxf	dmgv
𬹟	paxf	pamv
𬹠	mxf	mmgv
𬹡	wtxf	wtmv
𬹢	gjhx	gjhv
𬹣	rikn
𬹤	ujfn
𬹥	hndf
𬹦	hnda
𬹧	hndh
𬹨	hndx
𬹩	gkin
𬹪	axxn
𬹫	hndf
𬹬	hndi
𬹭	vnua
𬹮	vnus
𬹯	thlq
𬹰	thlk
𬹱	yvbj	yvbf
𬹲	ylf	yvul
𬹳	yjmu
𬹴	wycb
𬹵	hbes	hwws
𬹶	hbye	hwwe
𬹷	hbpf	hwwf
𬹸	hboh	hwwh
𬹹	hbaw	hwww
𬹺	hwbt
𬹻	hwbw
𬹼	hwbj
𬹽	hwbm
𬹾	hwbf
𬹿	hwbk
𬺀	vchb
𬺁	hwbf
𬺂	hwbm
𬺃	hwbn
𬺄	hwbd
𬺅	hwbt
𬺆	hwbe
𬺇	wdab
𬺈	hwbk
𬺉	hwbm
𬺊	hwbt
𬺋	hwbf
𬺌	hwbg
𬺍	hwbt
𬺎	udab
𬺏	hwbf
𬺐	hwbe
𬺑	hwbe
𬺒	godb
𬺓	hwbh
𬺔	hwbi
𬺕	hwby
𬺖	hwbf
𬺗	ujnh
𬺘	ujnm
𬺙	ujny
𬺚	ujne
𬺛	dxdu
𬺜	dxsu
𬺝	fnmx
𬺞	qkjn
𬺟	wgkq
𬺠	viwa
𬺡	gjha
